Sample,Chromosome,direction,start_index,end_index,position_block_size,start_position,end_position,chr_distance,start_value,end_value,value_change,measure_density,crosses_zero
Sample1,1,-1,1,12,11,530000,640000,110000,-0.2298863808902554,-0.268127496539947,-0.0382411156496916,1,FALSE
Sample1,1,1,12,54,42,640000,1140000,500000,-0.268127496539947,0.024580313415799075,0.2927078099557461,0.84,TRUE
Sample1,1,-1,54,76,22,1140000,1360000,220000,0.024580313415799075,-0.06002179533504981,-0.08460210875084889,1,TRUE
Sample1,1,1,76,93,17,1360000,1530000,170000,-0.06002179533504981,-0.012727721129091164,0.047294074205958644,1,FALSE
Sample1,1,-1,93,125,32,1530000,1850000,320000,-0.012727721129091164,-0.04786949241580324,-0.03514177128671207,1,FALSE
Sample1,1,1,125,146,21,1850000,2060000,210000,-0.04786949241580324,0.036544589321142434,0.08441408173694567,1,TRUE
Sample1,1,-1,146,158,12,2060000,2180000,120000,0.036544589321142434,0.010986465740828665,-0.02555812358031377,1,FALSE
Sample1,1,1,158,203,45,2180000,2630000,450000,0.010986465740828665,0.11854275547731224,0.10755628973648358,1,FALSE
Sample1,1,-1,203,271,68,2630000,3330000,700000,0.11854275547731224,-0.13956185098953972,-0.25810460646685196,0.9714285714285714,TRUE
Sample1,1,1,271,335,64,3330000,3970000,640000,-0.13956185098953972,0.16338396098196387,0.3029458119715036,1,TRUE
Sample1,1,-1,335,386,51,3970000,4480000,510000,0.16338396098196387,-0.01134147905394552,-0.1747254400359094,1,TRUE
Sample1,1,1,386,410,24,4480000,4720000,240000,-0.01134147905394552,0.0376677379472155,0.04900921700116102,1,TRUE
Sample1,1,-1,410,523,113,4720000,5850000,1130000,0.0376677379472155,-0.19996088577767704,-0.23762862372489255,1,TRUE
Sample1,1,1,523,559,36,5850000,6210000,360000,-0.19996088577767704,-0.07250871399947173,0.1274521717782053,1,FALSE
Sample1,1,-1,559,569,10,6210000,6310000,100000,-0.07250871399947173,-0.09003742602522827,-0.017528712025756538,1,FALSE
Sample1,1,1,569,623,54,6310000,6850000,540000,-0.09003742602522827,0.12302442025506703,0.2130618462802953,1,TRUE
Sample1,1,-1,623,668,45,6850000,7300000,450000,0.12302442025506703,-0.06323645598501519,-0.18626087624008222,1,TRUE
Sample1,1,1,668,679,11,7300000,7410000,110000,-0.06323645598501519,-0.04138500152079667,0.021851454464218524,1,FALSE
Sample1,1,-1,679,699,20,7410000,7610000,200000,-0.04138500152079667,-0.06524685768838992,-0.023861856167593253,1,FALSE
Sample1,1,1,699,710,11,7610000,7720000,110000,-0.06524685768838992,-0.04841594848644778,0.01683090920194214,1,FALSE
Sample1,1,-1,710,731,21,7720000,7930000,210000,-0.04841594848644778,-0.10309420036656464,-0.05467825188011686,1,FALSE
Sample1,1,1,731,780,49,7930000,8420000,490000,-0.10309420036656464,0.1281271066479075,0.23122130701447213,1,TRUE
Sample1,1,-1,780,811,31,8420000,8730000,310000,0.1281271066479075,-0.16310430214865565,-0.2912314087965632,1,TRUE
Sample1,1,1,811,835,24,8730000,8970000,240000,-0.16310430214865565,0.010740502658868147,0.1738448048075238,1,TRUE
Sample1,1,-1,835,850,15,8970000,9120000,150000,0.010740502658868147,-0.03927836040193387,-0.05001886306080202,1,TRUE
Sample1,1,1,850,874,24,9120000,9360000,240000,-0.03927836040193387,0.0398142611242858,0.07909262152621968,1,TRUE
Sample1,1,-1,874,923,49,9360000,9850000,490000,0.0398142611242858,-0.05684440735944835,-0.09665866848373415,1,TRUE
Sample1,1,1,923,946,23,9850000,10080000,230000,-0.05684440735944835,0.04092806451350708,0.09777247187295543,1,TRUE
Sample1,1,-1,946,957,11,10080000,10190000,110000,0.04092806451350708,0.014384281158853053,-0.026543783354654023,1,FALSE
Sample1,1,1,957,984,27,10190000,10460000,270000,0.014384281158853053,0.04297334010753921,0.028589058948686158,1,FALSE
Sample1,1,-1,984,1015,31,10460000,10770000,310000,0.04297334010753921,-0.08393052924328537,-0.1269038693508246,1,TRUE
Sample1,1,1,1015,1048,33,10770000,11100000,330000,-0.08393052924328537,0.07241952770509227,0.15635005694837764,1,TRUE
Sample1,1,-1,1048,1067,19,11100000,11290000,190000,0.07241952770509227,-0.0320882763444169,-0.10450780404950917,1,TRUE
Sample1,1,1,1067,1080,13,11290000,11420000,130000,-0.0320882763444169,-0.01340633754749527,0.018681938796921628,1,FALSE
Sample1,1,-1,1080,1099,19,11420000,11610000,190000,-0.01340633754749527,-0.08564110140920098,-0.0722347638617057,1,FALSE
Sample1,1,1,1099,1120,21,11610000,11820000,210000,-0.08564110140920098,0.003643611212124068,0.08928471262132505,1,TRUE
Sample1,1,-1,1120,1138,18,11820000,12000000,180000,0.003643611212124068,-0.024627137948696608,-0.028270749160820674,1,TRUE
Sample1,1,1,1138,1167,29,12000000,12290000,290000,-0.024627137948696608,0.17000978877340972,0.19463692672210633,1,TRUE
Sample1,1,-1,1167,1189,22,12290000,12510000,220000,0.17000978877340972,0.03570906386363793,-0.1343007249097718,1,FALSE
Sample1,1,1,1189,1218,29,12510000,12800000,290000,0.03570906386363793,0.12936257439128238,0.09365351052764445,1,FALSE
Sample1,1,-1,1218,1243,25,12800000,13540000,740000,0.12936257439128238,-0.020773771466066515,-0.1501363458573489,0.33783783783783783,TRUE
Sample1,1,1,1243,1269,26,13540000,13800000,260000,-0.020773771466066515,0.08269928085716141,0.10347305232322793,1,TRUE
Sample1,1,-1,1269,1297,28,13800000,14080000,280000,0.08269928085716141,0.00927043022846766,-0.07342885062869375,1,FALSE
Sample1,1,1,1297,1311,14,14080000,14220000,140000,0.00927043022846766,0.024705180182037576,0.015434749953569917,1,FALSE
Sample1,1,-1,1311,1340,29,14220000,14510000,290000,0.024705180182037576,-0.08481638259568126,-0.10952156277771884,1,TRUE
Sample1,1,1,1340,1353,13,14510000,14640000,130000,-0.08481638259568126,-0.07433231789357167,0.010484064702109594,1,FALSE
Sample1,1,-1,1353,1365,12,14640000,14760000,120000,-0.07433231789357167,-0.08559742075121132,-0.011265102857639653,1,FALSE
Sample1,1,1,1365,1381,16,14760000,14920000,160000,-0.08559742075121132,-0.058519116753011635,0.027078303998199688,1,FALSE
Sample1,1,-1,1381,1399,18,14920000,15100000,180000,-0.058519116753011635,-0.10422707016061021,-0.045707953407598576,1,FALSE
Sample1,1,1,1399,1429,30,15100000,15400000,300000,-0.10422707016061021,-0.01496871761225457,0.08925835254835564,1,FALSE
Sample1,1,-1,1429,1447,18,15400000,15580000,180000,-0.01496871761225457,-0.05206658634388489,-0.03709786873163032,1,FALSE
Sample1,1,1,1447,1468,21,15580000,15790000,210000,-0.05206658634388489,0.00536211433535832,0.05742870067924321,1,TRUE
Sample1,1,-1,1468,1487,19,15790000,15980000,190000,0.00536211433535832,-0.03386677098984949,-0.03922888532520781,1,TRUE
Sample1,1,1,1487,1515,28,15980000,16260000,280000,-0.03386677098984949,0.04104545475447199,0.07491222574432148,1,TRUE
Sample1,1,-1,1515,1552,37,16260000,16630000,370000,0.04104545475447199,-0.006721953764191572,-0.04776740851866356,1,TRUE
Sample1,1,1,1552,1569,17,16630000,16800000,170000,-0.006721953764191572,0.015681473708319016,0.02240342747251059,1,TRUE
Sample1,1,-1,1569,1579,10,16800000,16900000,100000,0.015681473708319016,0.007489293081683796,-0.00819218062663522,1,FALSE
Sample1,1,1,1579,1600,21,16900000,17110000,210000,0.007489293081683796,0.05089282508422747,0.04340353200254367,1,FALSE
Sample1,1,-1,1600,1626,26,17110000,17370000,260000,0.05089282508422747,-0.050506661191760706,-0.10139948627598817,1,TRUE
Sample1,1,1,1626,1656,30,17370000,17670000,300000,-0.050506661191760706,0.10761656754782982,0.15812322873959053,1,TRUE
Sample1,1,-1,1656,1699,43,17670000,18100000,430000,0.10761656754782982,-0.0047882135337558515,-0.11240478108158566,1,TRUE
Sample1,1,1,1699,1709,10,18100000,18200000,100000,-0.0047882135337558515,0.008147477695904796,0.012935691229660647,1,TRUE
Sample1,1,-1,1709,1739,30,18200000,18500000,300000,0.008147477695904796,-0.15822130244162994,-0.16636878013753473,1,TRUE
Sample1,1,1,1739,1762,23,18500000,18730000,230000,-0.15822130244162994,-0.007951801996478436,0.1502695004451515,1,FALSE
Sample1,1,-1,1762,1778,16,18730000,18890000,160000,-0.007951801996478436,-0.08534458501706202,-0.07739278302058358,1,FALSE
Sample1,1,1,1778,1804,26,18890000,19150000,260000,-0.08534458501706202,0.04310504997605302,0.12844963499311504,1,TRUE
Sample1,1,-1,1804,1833,29,19150000,19440000,290000,0.04310504997605302,-0.10549473006411934,-0.14859978004017238,1,TRUE
Sample1,1,1,1833,1879,46,19440000,19900000,460000,-0.10549473006411934,0.11954284476279592,0.22503757482691528,1,TRUE
Sample1,1,-1,1879,1934,55,19900000,20450000,550000,0.11954284476279592,-0.17150288194260851,-0.2910457267054044,1,TRUE
Sample1,1,1,1934,1969,35,20450000,20800000,350000,-0.17150288194260851,0.126862746146263,0.2983656280888715,1,TRUE
Sample1,1,-1,1969,1999,30,20800000,21100000,300000,0.126862746146263,-0.14819217079738575,-0.27505491694364875,1,TRUE
Sample1,1,1,1999,2036,37,21100000,21470000,370000,-0.14819217079738575,0.02087416591232147,0.16906633670970722,1,TRUE
Sample1,1,-1,2036,2067,31,21470000,21780000,310000,0.02087416591232147,-0.06389741227324758,-0.08477157818556905,1,TRUE
Sample1,1,1,2067,2095,28,21780000,22060000,280000,-0.06389741227324758,0.1032825363683839,0.1671799486416315,1,TRUE
Sample1,1,-1,2095,2116,21,22060000,22270000,210000,0.1032825363683839,-0.015689906669141288,-0.11897244303752519,1,TRUE
Sample1,1,1,2116,2132,16,22270000,22430000,160000,-0.015689906669141288,0.0287546389934124,0.04444454566255369,1,TRUE
Sample1,1,-1,2132,2173,41,22430000,22840000,410000,0.0287546389934124,-0.05466972922161592,-0.08342436821502833,1,TRUE
Sample1,1,1,2173,2190,17,22840000,23010000,170000,-0.05466972922161592,-0.027751793624253934,0.026917935597361987,1,FALSE
Sample1,1,-1,2190,2202,12,23010000,23130000,120000,-0.027751793624253934,-0.06118555519023188,-0.03343376156597795,1,FALSE
Sample1,1,1,2202,2256,54,23130000,23670000,540000,-0.06118555519023188,0.08733109446923948,0.14851664965947137,1,TRUE
Sample1,1,-1,2256,2278,22,23670000,23890000,220000,0.08733109446923948,-0.03295620548275449,-0.12028729995199397,1,TRUE
Sample1,1,1,2278,2300,22,23890000,24110000,220000,-0.03295620548275449,0.025133069186238602,0.05808927466899309,1,TRUE
Sample1,1,-1,2300,2342,42,24110000,24530000,420000,0.025133069186238602,-0.029032842454975553,-0.054165911641214155,1,TRUE
Sample1,1,1,2342,2369,27,24530000,24800000,270000,-0.029032842454975553,0.08184803288570303,0.11088087534067859,1,TRUE
Sample1,1,-1,2369,2420,51,24800000,25310000,510000,0.08184803288570303,-0.053491619046500634,-0.13533965193220365,1,TRUE
Sample1,1,1,2420,2446,26,25310000,25570000,260000,-0.053491619046500634,0.025190277690663215,0.07868189673716385,1,TRUE
Sample1,1,-1,2446,2474,28,25570000,25850000,280000,0.025190277690663215,-0.10259835929167851,-0.12778863698234172,1,TRUE
Sample1,1,1,2474,2499,25,25850000,26100000,250000,-0.10259835929167851,0.008106075625955906,0.11070443491763442,1,TRUE
Sample1,1,-1,2499,2514,15,26100000,26250000,150000,0.008106075625955906,-0.0041346696094905835,-0.01224074523544649,1,TRUE
Sample1,1,1,2514,2526,12,26250000,26370000,120000,-0.0041346696094905835,0.004553023189529944,0.008687692799020527,1,TRUE
Sample1,1,-1,2526,2541,15,26370000,26520000,150000,0.004553023189529944,-0.004725510364504462,-0.009278533554034405,1,TRUE
Sample1,1,1,2541,2563,22,26520000,26740000,220000,-0.004725510364504462,0.037191062275878845,0.04191657264038331,1,TRUE
Sample1,1,-1,2563,2584,21,26740000,26950000,210000,0.037191062275878845,-0.0012775083162483427,-0.03846857059212719,1,TRUE
Sample1,1,1,2584,2599,15,26950000,27100000,150000,-0.0012775083162483427,0.01104990650532597,0.012327414821574314,1,TRUE
Sample1,1,-1,2599,2637,38,27100000,27480000,380000,0.01104990650532597,-0.024214060561992105,-0.035263967067318075,1,TRUE
Sample1,1,1,2637,2666,29,27480000,27770000,290000,-0.024214060561992105,0.03834698255010037,0.06256104311209247,1,TRUE
Sample1,1,-1,2666,2706,40,27770000,28170000,400000,0.03834698255010037,-0.0386783498082072,-0.07702533235830758,1,TRUE
Sample1,1,1,2706,2728,22,28170000,28390000,220000,-0.0386783498082072,0.06316196991945361,0.1018403197276608,1,TRUE
Sample1,1,-1,2728,2750,22,28390000,28610000,220000,0.06316196991945361,-0.02992181488687067,-0.09308378480632427,1,TRUE
Sample1,1,1,2750,2783,33,28610000,28940000,330000,-0.02992181488687067,0.07387647754463196,0.10379829243150263,1,TRUE
Sample1,1,-1,2783,2802,19,28940000,29130000,190000,0.07387647754463196,0.04324351323743951,-0.03063296430719245,1,FALSE
Sample1,1,1,2802,2834,32,29130000,29450000,320000,0.04324351323743951,0.12610563143498424,0.08286211819754473,1,FALSE
Sample1,1,-1,2834,2873,39,29450000,29840000,390000,0.12610563143498424,-0.026531458636027058,-0.15263709007101128,1,TRUE
Sample1,1,1,2873,2905,32,29840000,30160000,320000,-0.026531458636027058,0.08204046720581874,0.1085719258418458,1,TRUE
Sample1,1,-1,2905,2949,44,30160000,30600000,440000,0.08204046720581874,-0.17120916029384226,-0.253249627499661,1,TRUE
Sample1,1,1,2949,2976,27,30600000,30870000,270000,-0.17120916029384226,0.02335579456872301,0.19456495486256525,1,TRUE
Sample1,1,-1,2976,2996,20,30870000,31070000,200000,0.02335579456872301,-0.0907759428344862,-0.11413173740320921,1,TRUE
Sample1,1,1,2996,3017,21,31070000,31280000,210000,-0.0907759428344862,0.07638038483917993,0.16715632767366612,1,TRUE
Sample1,1,-1,3017,3051,34,31280000,31620000,340000,0.07638038483917993,-0.091928447773105,-0.1683088326122849,1,TRUE
Sample1,1,1,3051,3093,42,31620000,32040000,420000,-0.091928447773105,0.06965519574380838,0.16158364351691337,1,TRUE
Sample1,1,-1,3093,3115,22,32040000,32260000,220000,0.06965519574380838,-0.02340981287635418,-0.09306500862016256,1,TRUE
Sample1,1,1,3115,3136,21,32260000,32470000,210000,-0.02340981287635418,0.02872674749585753,0.052136560372211704,1,TRUE
Sample1,1,-1,3136,3159,23,32470000,32700000,230000,0.02872674749585753,-0.04967453405745392,-0.07840128155331146,1,TRUE
Sample1,1,1,3159,3202,43,32700000,33130000,430000,-0.04967453405745392,0.07199889531913027,0.1216734293765842,1,TRUE
Sample1,1,-1,3202,3221,19,33130000,33320000,190000,0.07199889531913027,0.017499367464161444,-0.054499527854968824,1,FALSE
Sample1,1,1,3221,3246,25,33320000,33570000,250000,0.017499367464161444,0.1408059577898041,0.12330659032564265,1,FALSE
Sample1,1,-1,3246,3347,101,33570000,34580000,1010000,0.1408059577898041,-0.1947696973139912,-0.3355756551037953,1,TRUE
Sample1,1,1,3347,3380,33,34580000,34910000,330000,-0.1947696973139912,-0.017379035930423066,0.17739066138356815,1,FALSE
Sample1,1,-1,3380,3393,13,34910000,35040000,130000,-0.017379035930423066,-0.030661784762323195,-0.013282748831900129,1,FALSE
Sample1,1,1,3393,3420,27,35040000,35310000,270000,-0.030661784762323195,0.1386631078254188,0.169324892587742,1,TRUE
Sample1,1,-1,3420,3444,24,35310000,35550000,240000,0.1386631078254188,-0.09558887392338758,-0.23425198174880638,1,TRUE
Sample1,1,1,3444,3472,28,35550000,35830000,280000,-0.09558887392338758,0.02524876768839785,0.12083764161178542,1,TRUE
Sample1,1,-1,3472,3495,23,35830000,36060000,230000,0.02524876768839785,-0.08765894424199358,-0.11290771193039142,1,TRUE
Sample1,1,1,3495,3555,60,36060000,36660000,600000,-0.08765894424199358,0.1532174260850086,0.24087637032700218,1,TRUE
Sample1,1,-1,3555,3625,70,36660000,37360000,700000,0.1532174260850086,-0.14877866555067706,-0.30199609163568564,1,TRUE
Sample1,1,1,3625,3662,37,37360000,37730000,370000,-0.14877866555067706,0.04446643204374956,0.19324509759442662,1,TRUE
Sample1,1,-1,3662,3679,17,37730000,37900000,170000,0.04446643204374956,-0.02755122602608456,-0.07201765806983412,1,TRUE
Sample1,1,1,3679,3706,27,37900000,38170000,270000,-0.02755122602608456,0.18514950633645866,0.21270073236254322,1,TRUE
Sample1,1,-1,3706,3770,64,38170000,38810000,640000,0.18514950633645866,-0.18236340742510734,-0.36751291376156603,1,TRUE
Sample1,1,1,3770,3807,37,38810000,39180000,370000,-0.18236340742510734,0.08755746079071906,0.2699208682158264,1,TRUE
Sample1,1,-1,3807,3832,25,39180000,39430000,250000,0.08755746079071906,-0.09945763189494011,-0.1870150926856592,1,TRUE
Sample1,1,1,3832,3857,25,39430000,39680000,250000,-0.09945763189494011,0.04304398309540098,0.14250161499034109,1,TRUE
Sample1,1,-1,3857,3878,21,39680000,39890000,210000,0.04304398309540098,-0.010528463936256198,-0.05357244703165718,1,TRUE
Sample1,1,1,3878,3895,17,39890000,40060000,170000,-0.010528463936256198,0.02791576106119734,0.038444224997453535,1,TRUE
Sample1,1,-1,3895,3909,14,40060000,40200000,140000,0.02791576106119734,0.005255637246710394,-0.022660123814486947,1,FALSE
Sample1,1,1,3909,3926,17,40200000,40370000,170000,0.005255637246710394,0.06777183134098312,0.06251619409427273,1,FALSE
Sample1,1,-1,3926,3969,43,40370000,40800000,430000,0.06777183134098312,-0.038174939591948565,-0.10594677093293169,1,TRUE
Sample1,1,1,3969,3993,24,40800000,41040000,240000,-0.038174939591948565,0.07476136427415594,0.11293630386610451,1,TRUE
Sample1,1,-1,3993,4013,20,41040000,41240000,200000,0.07476136427415594,-0.08646216928417745,-0.1612235335583334,1,TRUE
Sample1,1,1,4013,4059,46,41240000,41700000,460000,-0.08646216928417745,0.07353887904216201,0.16000104832633946,1,TRUE
Sample1,1,-1,4059,4093,34,41700000,42040000,340000,0.07353887904216201,-0.05865722493142069,-0.1321961039735827,1,TRUE
Sample1,1,1,4093,4108,15,42040000,42190000,150000,-0.05865722493142069,-0.025210527201743105,0.03344669772967759,1,FALSE
Sample1,1,-1,4108,4120,12,42190000,42310000,120000,-0.025210527201743105,-0.035908177435002735,-0.01069765023325963,1,FALSE
Sample1,1,1,4120,4134,14,42310000,42450000,140000,-0.035908177435002735,0.0031775155195650478,0.039085692954567784,1,TRUE
Sample1,1,-1,4134,4150,16,42450000,42610000,160000,0.0031775155195650478,-0.030571629492631213,-0.03374914501219626,1,TRUE
Sample1,1,1,4150,4167,17,42610000,42780000,170000,-0.030571629492631213,0.03319653793843034,0.06376816743106155,1,TRUE
Sample1,1,-1,4167,4199,32,42780000,43100000,320000,0.03319653793843034,-0.09948585537983529,-0.13268239331826562,1,TRUE
Sample1,1,1,4199,4255,56,43100000,43660000,560000,-0.09948585537983529,0.0944248487673628,0.19391070414719808,1,TRUE
Sample1,1,-1,4255,4280,25,43660000,43910000,250000,0.0944248487673628,-0.06433503737521626,-0.15875988614257908,1,TRUE
Sample1,1,1,4280,4301,21,43910000,44120000,210000,-0.06433503737521626,0.09206676390504631,0.15640180128026257,1,TRUE
Sample1,1,-1,4301,4323,22,44120000,44340000,220000,0.09206676390504631,-0.032260107661416196,-0.12432687156646251,1,TRUE
Sample1,1,1,4323,4337,14,44340000,44480000,140000,-0.032260107661416196,0.008158623207707763,0.04041873086912396,1,TRUE
Sample1,1,-1,4337,4353,16,44480000,44640000,160000,0.008158623207707763,-0.04285071451245553,-0.05100933772016329,1,TRUE
Sample1,1,1,4353,4380,27,44640000,44910000,270000,-0.04285071451245553,0.1129618062844321,0.15581252079688762,1,TRUE
Sample1,1,-1,4380,4429,49,44910000,45400000,490000,0.1129618062844321,-0.059575384008063434,-0.17253719029249553,1,TRUE
Sample1,1,1,4429,4477,48,45400000,45880000,480000,-0.059575384008063434,0.07658174087689107,0.13615712488495452,1,TRUE
Sample1,1,-1,4477,4500,23,45880000,46110000,230000,0.07658174087689107,-0.11568089653919063,-0.19226263741608168,1,TRUE
Sample1,1,1,4500,4569,69,46110000,46800000,690000,-0.11568089653919063,0.12084301341122834,0.23652390995041897,1,TRUE
Sample1,1,-1,4569,4598,29,46800000,47090000,290000,0.12084301341122834,-0.12317962899083457,-0.2440226424020629,1,TRUE
Sample1,1,1,4598,4635,37,47090000,47460000,370000,-0.12317962899083457,0.08110099353280784,0.2042806225236424,1,TRUE
Sample1,1,-1,4635,4654,19,47460000,47650000,190000,0.08110099353280784,0.05331073104448465,-0.027790262488323184,1,FALSE
Sample1,1,1,4654,4670,16,47650000,47810000,160000,0.05331073104448465,0.08618581512854197,0.032875084084057316,1,FALSE
Sample1,1,-1,4670,4687,17,47810000,47980000,170000,0.08618581512854197,0.058402551422143026,-0.027783263706398942,1,FALSE
Sample1,1,1,4687,4703,16,47980000,48140000,160000,0.058402551422143026,0.08673883896848965,0.028336287546346622,1,FALSE
Sample1,1,-1,4703,4731,28,48140000,48420000,280000,0.08673883896848965,-0.11487525462230908,-0.20161409359079874,1,TRUE
Sample1,1,1,4731,4766,35,48420000,48770000,350000,-0.11487525462230908,0.09087384796231512,0.2057491025846242,1,TRUE
Sample1,1,-1,4766,4789,23,48770000,49000000,230000,0.09087384796231512,0.013582938808229285,-0.07729090915408585,1,FALSE
Sample1,1,1,4789,4808,19,49000000,49190000,190000,0.013582938808229285,0.04419101940068017,0.030608080592450883,1,FALSE
Sample1,1,-1,4808,4875,67,49190000,49860000,670000,0.04419101940068017,-0.16143362439148257,-0.20562464379216272,1,TRUE
Sample1,1,1,4875,4896,21,49860000,50070000,210000,-0.16143362439148257,-0.09524237077985998,0.06619125361162259,1,FALSE
Sample1,1,-1,4896,4913,17,50070000,50240000,170000,-0.09524237077985998,-0.17959715342188104,-0.08435478264202106,1,FALSE
Sample1,1,1,4913,4941,28,50240000,50520000,280000,-0.17959715342188104,0.14009615050282487,0.3196933039247059,1,TRUE
Sample1,1,-1,4941,4975,34,50520000,50860000,340000,0.14009615050282487,-0.21099834798808376,-0.3510944984909086,1,TRUE
Sample1,1,1,4975,5006,31,50860000,51170000,310000,-0.21099834798808376,0.006098962064047994,0.21709731005213176,1,TRUE
Sample1,1,-1,5006,5036,30,51170000,51470000,300000,0.006098962064047994,-0.06519651028368612,-0.0712954723477341,1,TRUE
Sample1,1,1,5036,5057,21,51470000,51680000,210000,-0.06519651028368612,0.08206894440169872,0.14726545468538482,1,TRUE
Sample1,1,-1,5057,5075,18,51680000,51860000,180000,0.08206894440169872,-0.03762620230559817,-0.11969514670729689,1,TRUE
Sample1,1,1,5075,5111,36,51860000,52220000,360000,-0.03762620230559817,0.11931344796789227,0.15693965027349044,1,TRUE
Sample1,1,-1,5111,5139,28,52220000,52500000,280000,0.11931344796789227,-0.1380252295703323,-0.2573386775382246,1,TRUE
Sample1,1,1,5139,5170,31,52500000,52810000,310000,-0.1380252295703323,0.1185083355340231,0.25653356510435543,1,TRUE
Sample1,1,-1,5170,5198,28,52810000,53090000,280000,0.1185083355340231,-0.061593008701406986,-0.1801013442354301,1,TRUE
Sample1,1,1,5198,5230,32,53090000,53410000,320000,-0.061593008701406986,0.037120783567784046,0.09871379226919103,1,TRUE
Sample1,1,-1,5230,5271,41,53410000,53820000,410000,0.037120783567784046,-0.03145741224931324,-0.06857819581709729,1,TRUE
Sample1,1,1,5271,5299,28,53820000,54100000,280000,-0.03145741224931324,0.03885251591791855,0.07030992816723179,1,TRUE
Sample1,1,-1,5299,5326,27,54100000,54370000,270000,0.03885251591791855,-0.07858957058085432,-0.11744208649877287,1,TRUE
Sample1,1,1,5326,5348,22,54370000,54590000,220000,-0.07858957058085432,0.05525422631581764,0.13384379689667197,1,TRUE
Sample1,1,-1,5348,5360,12,54590000,54710000,120000,0.05525422631581764,0.016248565104013374,-0.039005661211804266,1,FALSE
Sample1,1,1,5360,5424,64,54710000,55350000,640000,0.016248565104013374,0.18139710775601706,0.16514854265200368,1,FALSE
Sample1,1,-1,5424,5529,105,55350000,56400000,1050000,0.18139710775601706,-0.06004346755558307,-0.24144057531160013,1,TRUE
Sample1,1,1,5529,5572,43,56400000,56830000,430000,-0.06004346755558307,0.12458541343200506,0.18462888098758812,1,TRUE
Sample1,1,-1,5572,5738,166,56830000,58490000,1660000,0.12458541343200506,-0.20869178258334967,-0.3332771960153547,1,TRUE
Sample1,1,1,5738,5783,45,58490000,58940000,450000,-0.20869178258334967,0.09605886466424367,0.3047506472475933,1,TRUE
Sample1,1,-1,5783,5804,21,58940000,59150000,210000,0.09605886466424367,0.01405991749600683,-0.08199894716823684,1,FALSE
Sample1,1,1,5804,5831,27,59150000,59420000,270000,0.01405991749600683,0.15419238386748824,0.1401324663714814,1,FALSE
Sample1,1,-1,5831,5861,30,59420000,59720000,300000,0.15419238386748824,-0.04960555121675182,-0.20379793508424005,1,TRUE
Sample1,1,1,5861,5895,34,59720000,60060000,340000,-0.04960555121675182,0.12008016129906744,0.16968571251581926,1,TRUE
Sample1,1,-1,5895,5975,80,60060000,60860000,800000,0.12008016129906744,-0.22143842910825942,-0.34151859040732685,1,TRUE
Sample1,1,1,5975,6008,33,60860000,61190000,330000,-0.22143842910825942,0.15089890210450826,0.3723373312127677,1,TRUE
Sample1,1,-1,6008,6037,29,61190000,61480000,290000,0.15089890210450826,-0.0912851939372979,-0.24218409604180618,1,TRUE
Sample1,1,1,6037,6075,38,61480000,61860000,380000,-0.0912851939372979,0.14034839939947347,0.23163359333677136,1,TRUE
Sample1,1,-1,6075,6105,30,61860000,62160000,300000,0.14034839939947347,-0.039709279392283615,-0.18005767879175708,1,TRUE
Sample1,1,1,6105,6132,27,62160000,62430000,270000,-0.039709279392283615,0.07452424743998398,0.11423352683226759,1,TRUE
Sample1,1,-1,6132,6153,21,62430000,62640000,210000,0.07452424743998398,-0.07902038763000718,-0.15354463506999116,1,TRUE
Sample1,1,1,6153,6176,23,62640000,62870000,230000,-0.07902038763000718,0.09783493240583623,0.17685532003584342,1,TRUE
Sample1,1,-1,6176,6207,31,62870000,63180000,310000,0.09783493240583623,-0.053368350948345605,-0.15120328335418182,1,TRUE
Sample1,1,1,6207,6231,24,63180000,63420000,240000,-0.053368350948345605,0.1116534308212548,0.16502178176960042,1,TRUE
Sample1,1,-1,6231,6249,18,63420000,63600000,180000,0.1116534308212548,-0.0020398272862198544,-0.11369325810747466,1,TRUE
Sample1,1,1,6249,6267,18,63600000,63780000,180000,-0.0020398272862198544,0.06204206244439469,0.06408188973061454,1,TRUE
Sample1,1,-1,6267,6304,37,63780000,64150000,370000,0.06204206244439469,-0.19503346003247246,-0.25707552247686716,1,TRUE
Sample1,1,1,6304,6337,33,64150000,64480000,330000,-0.19503346003247246,0.11547648005052898,0.3105099400830014,1,TRUE
Sample1,1,-1,6337,6383,46,64480000,64940000,460000,0.11547648005052898,-0.054542111569527346,-0.17001859162005634,1,TRUE
Sample1,1,1,6383,6411,28,64940000,65220000,280000,-0.054542111569527346,0.10549704216044119,0.16003915372996852,1,TRUE
Sample1,1,-1,6411,6449,38,65220000,65600000,380000,0.10549704216044119,-0.02903320003815405,-0.13453024219859525,1,TRUE
Sample1,1,1,6449,6459,10,65600000,65700000,100000,-0.02903320003815405,-0.015080109355261575,0.013953090682892477,1,FALSE
Sample1,1,-1,6459,6506,47,65700000,66170000,470000,-0.015080109355261575,-0.10179236223985996,-0.08671225288459838,1,FALSE
Sample1,1,1,6506,6570,64,66170000,66810000,640000,-0.10179236223985996,0.07267636922591066,0.17446873146577063,1,TRUE
Sample1,1,-1,6570,6599,29,66810000,67100000,290000,0.07267636922591066,-0.06057995625525184,-0.1332563254811625,1,TRUE
Sample1,1,1,6599,6613,14,67100000,67240000,140000,-0.06057995625525184,-0.04224204615518196,0.018337910100069875,1,FALSE
Sample1,1,-1,6613,6630,17,67240000,67410000,170000,-0.04224204615518196,-0.06172672911562293,-0.019484682960440966,1,FALSE
Sample1,1,1,6630,6675,45,67410000,67860000,450000,-0.06172672911562293,0.1333601383922018,0.19508686750782472,1,TRUE
Sample1,1,-1,6675,6711,36,67860000,68220000,360000,0.1333601383922018,-0.06958500697735255,-0.20294514536955433,1,TRUE
Sample1,1,1,6711,6751,40,68220000,68620000,400000,-0.06958500697735255,0.17043076269128984,0.2400157696686424,1,TRUE
Sample1,1,-1,6751,6871,120,68620000,69820000,1200000,0.17043076269128984,-0.07458427483297833,-0.24501503752426818,1,TRUE
Sample1,1,1,6871,6892,21,69820000,70030000,210000,-0.07458427483297833,-0.05577407159425072,0.01881020323872761,1,FALSE
Sample1,1,-1,6892,6913,21,70030000,70240000,210000,-0.05577407159425072,-0.097197444063638,-0.041423372469387286,1,FALSE
Sample1,1,1,6913,6944,31,70240000,70550000,310000,-0.097197444063638,0.15839172094681803,0.25558916501045603,1,TRUE
Sample1,1,-1,6944,6984,40,70550000,70950000,400000,0.15839172094681803,-0.05402447452424649,-0.21241619547106452,1,TRUE
Sample1,1,1,6984,7041,57,70950000,71520000,570000,-0.05402447452424649,0.1532176082659446,0.2072420827901911,1,TRUE
Sample1,1,-1,7041,7110,69,71520000,72210000,690000,0.1532176082659446,-0.18394760376853483,-0.33716521203447947,1,TRUE
Sample1,1,1,7110,7154,44,72210000,72650000,440000,-0.18394760376853483,0.02177121446946279,0.20571881823799762,1,TRUE
Sample1,1,-1,7154,7173,19,72650000,72840000,190000,0.02177121446946279,-0.019782108779634454,-0.041553323249097246,1,TRUE
Sample1,1,1,7173,7220,47,72840000,73310000,470000,-0.019782108779634454,0.03269605976230725,0.052478168541941705,1,TRUE
Sample1,1,-1,7220,7257,37,73310000,73680000,370000,0.03269605976230725,-0.033145298102203,-0.06584135786451026,1,TRUE
Sample1,1,1,7257,7281,24,73680000,73920000,240000,-0.033145298102203,0.01649940787875684,0.04964470598095984,1,TRUE
Sample1,1,-1,7281,7292,11,73920000,74030000,110000,0.01649940787875684,0.0046021044273624155,-0.011897303451394423,1,FALSE
Sample1,1,1,7292,7314,22,74030000,74250000,220000,0.0046021044273624155,0.04073257715235418,0.03613047272499176,1,FALSE
Sample1,1,-1,7314,7341,27,74250000,74520000,270000,0.04073257715235418,-0.031149695446746544,-0.07188227259910072,1,TRUE
Sample1,1,1,7341,7366,25,74520000,74770000,250000,-0.031149695446746544,0.033328823027070645,0.06447851847381719,1,TRUE
Sample1,1,-1,7366,7392,26,74770000,75030000,260000,0.033328823027070645,-0.01617013546420346,-0.0494989584912741,1,TRUE
Sample1,1,1,7392,7409,17,75030000,75200000,170000,-0.01617013546420346,0.033536778161405476,0.04970691362560893,1,TRUE
Sample1,1,-1,7409,7446,37,75200000,75570000,370000,0.033536778161405476,-0.09920569852581619,-0.13274247668722167,1,TRUE
Sample1,1,1,7446,7475,29,75570000,75860000,290000,-0.09920569852581619,0.11709495014907303,0.21630064867488924,1,TRUE
Sample1,1,-1,7475,7592,117,75860000,77030000,1170000,0.11709495014907303,-0.12573481353384067,-0.2428297636829137,1,TRUE
Sample1,1,1,7592,7616,24,77030000,77270000,240000,-0.12573481353384067,-0.09116558517314703,0.034569228360693635,1,FALSE
Sample1,1,-1,7616,7634,18,77270000,77450000,180000,-0.09116558517314703,-0.1388392096868089,-0.047673624513661875,1,FALSE
Sample1,1,1,7634,7713,79,77450000,78240000,790000,-0.1388392096868089,0.20031636693233956,0.33915557661914847,1,TRUE
Sample1,1,-1,7713,7748,35,78240000,78590000,350000,0.20031636693233956,-0.023047653027426625,-0.22336401995976618,1,TRUE
Sample1,1,1,7748,7780,32,78590000,78910000,320000,-0.023047653027426625,0.04542749565235158,0.0684751486797782,1,TRUE
Sample1,1,-1,7780,7806,26,78910000,79170000,260000,0.04542749565235158,-0.01266703079525382,-0.058094526447605405,1,TRUE
Sample1,1,1,7806,7833,27,79170000,79440000,270000,-0.01266703079525382,0.08374271680398179,0.09640974759923561,1,TRUE
Sample1,1,-1,7833,7889,56,79440000,80000000,560000,0.08374271680398179,0.0062736638061694095,-0.07746905299781238,1,FALSE
Sample1,1,1,7889,7906,17,80000000,80170000,170000,0.0062736638061694095,0.02007890734973616,0.01380524354356675,1,FALSE
Sample1,1,-1,7906,7941,35,80170000,80520000,350000,0.02007890734973616,-0.03478105441504004,-0.0548599617647762,1,TRUE
Sample1,1,1,7941,7961,20,80520000,80720000,200000,-0.03478105441504004,-0.01876913113136456,0.016011923283675483,1,FALSE
Sample1,1,-1,7961,7973,12,80720000,80840000,120000,-0.01876913113136456,-0.030392740060965998,-0.011623608929601438,1,FALSE
Sample1,1,1,7973,8009,36,80840000,81200000,360000,-0.030392740060965998,-0.002521304927929867,0.02787143513303613,1,FALSE
Sample1,1,-1,8009,8045,36,81200000,81560000,360000,-0.002521304927929867,-0.07537104468899594,-0.07284973976106607,1,FALSE
Sample1,1,1,8045,8073,28,81560000,81840000,280000,-0.07537104468899594,0.07826490696834727,0.15363595165734323,1,TRUE
Sample1,1,-1,8073,8092,19,81840000,82030000,190000,0.07826490696834727,-0.004169990409088688,-0.08243489737743596,1,TRUE
Sample1,1,1,8092,8107,15,82030000,82180000,150000,-0.004169990409088688,0.004008980191139551,0.00817897060022824,1,TRUE
Sample1,1,-1,8107,8134,27,82180000,82450000,270000,0.004008980191139551,-0.08499933399239483,-0.08900831418353439,1,TRUE
Sample1,1,1,8134,8159,25,82450000,82700000,250000,-0.08499933399239483,0.061764686450018716,0.14676402044241355,1,TRUE
Sample1,1,-1,8159,8178,19,82700000,82890000,190000,0.061764686450018716,-0.016336450251402762,-0.07810113670142148,1,TRUE
Sample1,1,1,8178,8199,21,82890000,83100000,210000,-0.016336450251402762,0.006997283323874583,0.023333733575277345,1,TRUE
Sample1,1,-1,8199,8260,61,83100000,83920000,820000,0.006997283323874583,-0.1876580186799631,-0.19465530200383768,0.7439024390243902,TRUE
Sample1,1,1,8260,8284,24,83920000,84160000,240000,-0.1876580186799631,4.425254762342925e-4,0.1881005441561974,1,TRUE
Sample1,1,-1,8284,8298,14,84160000,84300000,140000,4.425254762342925e-4,-0.02355150521641493,-0.023994030692649222,1,TRUE
Sample1,1,1,8298,8317,19,84300000,84490000,190000,-0.02355150521641493,0.02640454728795393,0.04995605250436886,1,TRUE
Sample1,1,-1,8317,8331,14,84490000,84630000,140000,0.02640454728795393,0.017224643858851862,-0.009179903429102066,1,FALSE
Sample1,1,1,8331,8346,15,84630000,84780000,150000,0.017224643858851862,0.032571030844147836,0.015346386985295973,1,FALSE
Sample1,1,-1,8346,8374,28,84780000,85060000,280000,0.032571030844147836,-0.10825475175173915,-0.140825782595887,1,TRUE
Sample1,1,1,8374,8403,29,85060000,85350000,290000,-0.10825475175173915,0.07801562231468281,0.18627037406642197,1,TRUE
Sample1,1,-1,8403,8425,22,85350000,85570000,220000,0.07801562231468281,-0.09589085248882584,-0.17390647480350865,1,TRUE
Sample1,1,1,8425,8461,36,85570000,85930000,360000,-0.09589085248882584,0.12757945771617923,0.22347031020500507,1,TRUE
Sample1,1,-1,8461,8504,43,85930000,86360000,430000,0.12757945771617923,-0.039483550881421026,-0.16706300859760026,1,TRUE
Sample1,1,1,8504,8518,14,86360000,86500000,140000,-0.039483550881421026,-0.01838822634359245,0.021095324537828575,1,FALSE
Sample1,1,-1,8518,8536,18,86500000,86680000,180000,-0.01838822634359245,-0.1042149081536724,-0.08582668181007995,1,FALSE
Sample1,1,1,8536,8565,29,86680000,86970000,290000,-0.1042149081536724,0.19269462616820462,0.29690953432187706,1,TRUE
Sample1,1,-1,8565,8643,78,86970000,87750000,780000,0.19269462616820462,-0.05483131161393192,-0.24752593778213655,1,TRUE
Sample1,1,1,8643,8673,30,87750000,88050000,300000,-0.05483131161393192,0.04616184355687541,0.10099315517080733,1,TRUE
Sample1,1,-1,8673,8717,44,88050000,88490000,440000,0.04616184355687541,-0.1484583090712403,-0.19462015262811572,1,TRUE
Sample1,1,1,8717,8772,55,88490000,89040000,550000,-0.1484583090712403,0.10633310707523513,0.25479141614647544,1,TRUE
Sample1,1,-1,8772,8836,64,89040000,89680000,640000,0.10633310707523513,-0.08944083964255113,-0.19577394671778625,1,TRUE
Sample1,1,1,8836,8882,46,89680000,90140000,460000,-0.08944083964255113,0.15965585492869375,0.2490966945712449,1,TRUE
Sample1,1,-1,8882,8933,51,90140000,90650000,510000,0.15965585492869375,-0.07233246704640421,-0.23198832197509794,1,TRUE
Sample1,1,1,8933,8949,16,90650000,90810000,160000,-0.07233246704640421,-0.031051565142977754,0.041280901903426453,1,FALSE
Sample1,1,-1,8949,8965,16,90810000,90970000,160000,-0.031051565142977754,-0.09549875190231057,-0.06444718675933281,1,FALSE
Sample1,1,1,8965,8984,19,90970000,91160000,190000,-0.09549875190231057,0.02055786526697719,0.11605661716928775,1,TRUE
Sample1,1,-1,8984,9004,20,91160000,91360000,200000,0.02055786526697719,-0.08157521119789307,-0.10213307646487026,1,TRUE
Sample1,1,1,9004,9029,25,91360000,91610000,250000,-0.08157521119789307,0.027987186222824836,0.10956239742071791,1,TRUE
Sample1,1,-1,9029,9053,24,91610000,91850000,240000,0.027987186222824836,-0.11428415853946748,-0.1422713447622923,1,TRUE
Sample1,1,1,9053,9083,30,91850000,92150000,300000,-0.11428415853946748,0.005179504419163691,0.11946366295863117,1,TRUE
Sample1,1,-1,9083,9104,21,92150000,92360000,210000,0.005179504419163691,-0.04536526729943956,-0.05054477171860325,1,TRUE
Sample1,1,1,9104,9120,16,92360000,92520000,160000,-0.04536526729943956,-0.004522641561838018,0.04084262573760154,1,FALSE
Sample1,1,-1,9120,9138,18,92520000,92700000,180000,-0.004522641561838018,-0.11195368337036109,-0.10743104180852307,1,FALSE
Sample1,1,1,9138,9179,41,92700000,93110000,410000,-0.11195368337036109,0.06682995571418743,0.17878363908454853,1,TRUE
Sample1,1,-1,9179,9198,19,93110000,93300000,190000,0.06682995571418743,-0.053926435188372035,-0.12075639090255946,1,TRUE
Sample1,1,1,9198,9216,18,93300000,93480000,180000,-0.053926435188372035,0.010914147715778881,0.06484058290415091,1,TRUE
Sample1,1,-1,9216,9233,17,93480000,93650000,170000,0.010914147715778881,-0.059123117208218966,-0.07003726492399785,1,TRUE
Sample1,1,1,9233,9266,33,93650000,93980000,330000,-0.059123117208218966,0.11960758848680839,0.17873070569502736,1,TRUE
Sample1,1,-1,9266,9294,28,93980000,94260000,280000,0.11960758848680839,-0.028183470595080057,-0.14779105908188844,1,TRUE
Sample1,1,1,9294,9314,20,94260000,94460000,200000,-0.028183470595080057,0.02288859593309141,0.051072066528171464,1,TRUE
Sample1,1,-1,9314,9349,35,94460000,94810000,350000,0.02288859593309141,-0.06814652148287276,-0.09103511741596416,1,TRUE
Sample1,1,1,9349,9401,52,94810000,95330000,520000,-0.06814652148287276,0.1408234069750096,0.20896992845788237,1,TRUE
Sample1,1,-1,9401,9434,33,95330000,95660000,330000,0.1408234069750096,9.446846452472318e-4,-0.1398787223297624,1,FALSE
Sample1,1,1,9434,9447,13,95660000,95790000,130000,9.446846452472318e-4,0.022166251664668138,0.021221567019420906,1,FALSE
Sample1,1,-1,9447,9498,51,95790000,96300000,510000,0.022166251664668138,-0.08043111474672904,-0.10259736641139718,1,TRUE
Sample1,1,1,9498,9545,47,96300000,96770000,470000,-0.08043111474672904,0.019954899884299666,0.1003860146310287,1,TRUE
Sample1,1,-1,9545,9559,14,96770000,96910000,140000,0.019954899884299666,-0.015354945978709697,-0.035309845863009365,1,TRUE
Sample1,1,1,9559,9584,25,96910000,97160000,250000,-0.015354945978709697,0.10094294278858927,0.11629788876729896,1,TRUE
Sample1,1,-1,9584,9651,67,97160000,97830000,670000,0.10094294278858927,-0.16344804107056668,-0.26439098385915594,1,TRUE
Sample1,1,1,9651,9677,26,97830000,98090000,260000,-0.16344804107056668,0.03338300061589318,0.19683104168645987,1,TRUE
Sample1,1,-1,9677,9696,19,98090000,98280000,190000,0.03338300061589318,-0.08847453992988336,-0.12185754054577654,1,TRUE
Sample1,1,1,9696,9723,27,98280000,98550000,270000,-0.08847453992988336,0.07428643471058335,0.1627609746404667,1,TRUE
Sample1,1,-1,9723,9748,25,98550000,98800000,250000,0.07428643471058335,0.02126081426910046,-0.053025620441482894,1,FALSE
Sample1,1,1,9748,9758,10,98800000,98900000,100000,0.02126081426910046,0.032694669791314544,0.011433855522214084,1,FALSE
Sample1,1,-1,9758,9812,54,98900000,99440000,540000,0.032694669791314544,-0.13769796366834247,-0.17039263345965702,1,TRUE
Sample1,1,1,9812,9867,55,99440000,99990000,550000,-0.13769796366834247,0.027813281694532132,0.1655112453628746,1,TRUE
Sample1,1,-1,9867,9883,16,99990000,100150000,160000,0.027813281694532132,-0.04195283778982087,-0.069766119484353,1,TRUE
Sample1,1,1,9883,9907,24,100150000,100390000,240000,-0.04195283778982087,0.09722208427737233,0.1391749220671932,1,TRUE
Sample1,1,-1,9907,9973,66,100390000,101050000,660000,0.09722208427737233,-0.1254249676243,-0.22264705190167233,1,TRUE
Sample1,1,1,9973,9999,26,101050000,101310000,260000,-0.1254249676243,0.1763366547554153,0.30176162237971527,1,TRUE
Sample1,1,-1,9999,10023,24,101310000,101550000,240000,0.1763366547554153,0.0970493559431583,-0.07928729881225699,1,FALSE
Sample1,1,1,10023,10033,10,101550000,101650000,100000,0.0970493559431583,0.10588333260817163,0.00883397666501333,1,FALSE
Sample1,1,-1,10033,10124,91,101650000,102560000,910000,0.10588333260817163,-0.09783226674487036,-0.203715599353042,1,TRUE
Sample1,1,1,10124,10171,47,102560000,103030000,470000,-0.09783226674487036,0.033292851055060003,0.13112511779993036,1,TRUE
Sample1,1,-1,10171,10190,19,103030000,103220000,190000,0.033292851055060003,0.013439607180284205,-0.0198532438747758,1,FALSE
Sample1,1,1,10190,10207,17,103220000,103390000,170000,0.013439607180284205,0.02661048050787548,0.013170873327591275,1,FALSE
Sample1,1,-1,10207,10236,29,103390000,103770000,380000,0.02661048050787548,-0.029402199023977255,-0.05601267953185274,0.7631578947368421,TRUE
Sample1,1,1,10236,10258,22,103770000,103990000,220000,-0.029402199023977255,0.027383491840890818,0.05678569086486807,1,TRUE
Sample1,1,-1,10258,10276,18,103990000,104170000,180000,0.027383491840890818,-0.002601992390721299,-0.029985484231612118,1,TRUE
Sample1,1,1,10276,10293,17,104170000,104340000,170000,-0.002601992390721299,0.012541268073834641,0.015143260464555941,1,TRUE
Sample1,1,-1,10293,10317,24,104340000,104580000,240000,0.012541268073834641,-0.013945303266658963,-0.026486571340493606,1,TRUE
Sample1,1,1,10317,10338,21,104580000,104790000,210000,-0.013945303266658963,0.006855135777115318,0.02080043904377428,1,TRUE
Sample1,1,-1,10338,10359,21,104790000,105000000,210000,0.006855135777115318,-0.03586322154109546,-0.042718357318210776,1,TRUE
Sample1,1,1,10359,10403,44,105000000,105440000,440000,-0.03586322154109546,0.02023213599058558,0.056095357531681045,1,TRUE
Sample1,1,-1,10403,10422,19,105440000,105630000,190000,0.02023213599058558,4.909565891673303e-4,-0.01974117940141825,1,FALSE
Sample1,1,1,10422,10442,20,105630000,105830000,200000,4.909565891673303e-4,0.02083741680519187,0.02034646021602454,1,FALSE
Sample1,1,-1,10442,10492,50,105830000,106330000,500000,0.02083741680519187,-0.023464497757348313,-0.04430191456254018,1,TRUE
Sample1,1,1,10492,10511,19,106330000,106520000,190000,-0.023464497757348313,0.004920371853992478,0.02838486961134079,1,TRUE
Sample1,1,-1,10511,10553,42,106520000,106940000,420000,0.004920371853992478,-0.0425203218415532,-0.04744069369554568,1,TRUE
Sample1,1,1,10553,10575,22,106940000,107160000,220000,-0.0425203218415532,0.021625573506328547,0.06414589534788175,1,TRUE
Sample1,1,-1,10575,10640,65,107160000,107810000,650000,0.021625573506328547,-0.14028689326358684,-0.1619124667699154,1,TRUE
Sample1,1,1,10640,10672,32,107810000,108130000,320000,-0.14028689326358684,-0.03576332084126521,0.10452357242232163,1,FALSE
Sample1,1,-1,10672,10692,20,108130000,108390000,260000,-0.03576332084126521,-0.11750037806815829,-0.08173705722689308,0.7692307692307693,FALSE
Sample1,1,1,10692,10735,43,108390000,108820000,430000,-0.11750037806815829,0.036682968797005576,0.15418334686516386,1,TRUE
Sample1,1,-1,10735,10756,21,108820000,109030000,210000,0.036682968797005576,-0.05799113075002584,-0.09467409954703142,1,TRUE
Sample1,1,1,10756,10781,25,109030000,109280000,250000,-0.05799113075002584,0.04514414033752204,0.10313527108754789,1,TRUE
Sample1,1,-1,10781,10796,15,109280000,109430000,150000,0.04514414033752204,0.025839971102489787,-0.01930416923503225,1,FALSE
Sample1,1,1,10796,10812,16,109430000,109590000,160000,0.025839971102489787,0.050566202212729595,0.024726231110239808,1,FALSE
Sample1,1,-1,10812,10848,36,109590000,109950000,360000,0.050566202212729595,-0.07271230199233167,-0.12327850420506126,1,TRUE
Sample1,1,1,10848,10915,67,109950000,110620000,670000,-0.07271230199233167,0.15809197898075694,0.2308042809730886,1,TRUE
Sample1,1,-1,10915,10958,43,110620000,111050000,430000,0.15809197898075694,-0.029977464719832324,-0.18806944370058926,1,TRUE
Sample1,1,1,10958,10971,13,111050000,111180000,130000,-0.029977464719832324,-0.011805595530052176,0.01817186918978015,1,FALSE
Sample1,1,-1,10971,10993,22,111180000,111400000,220000,-0.011805595530052176,-0.09620997365077413,-0.08440437812072196,1,FALSE
Sample1,1,1,10993,11040,47,111400000,111870000,470000,-0.09620997365077413,0.1013861655159928,0.19759613916676694,1,TRUE
Sample1,1,-1,11040,11080,40,111870000,112270000,400000,0.1013861655159928,-0.15957523690560396,-0.26096140242159677,1,TRUE
Sample1,1,1,11080,11113,33,112270000,112600000,330000,-0.15957523690560396,0.03624192120040308,0.19581715810600703,1,TRUE
Sample1,1,-1,11113,11126,13,112600000,112730000,130000,0.03624192120040308,0.010662746370553167,-0.025579174829849914,1,FALSE
Sample1,1,1,11126,11144,18,112730000,112910000,180000,0.010662746370553167,0.059036551684657206,0.04837380531410404,1,FALSE
Sample1,1,-1,11144,11156,12,112910000,113030000,120000,0.059036551684657206,0.038171631718194265,-0.02086491996646294,1,FALSE
Sample1,1,1,11156,11196,40,113030000,113430000,400000,0.038171631718194265,0.11371193409263622,0.07554030237444195,1,FALSE
Sample1,1,-1,11196,11225,29,113430000,113720000,290000,0.11371193409263622,-0.17649339444950105,-0.29020532854213726,1,TRUE
Sample1,1,1,11225,11258,33,113720000,114050000,330000,-0.17649339444950105,0.04708982580671141,0.22358322025621247,1,TRUE
Sample1,1,-1,11258,11299,41,114050000,114460000,410000,0.04708982580671141,-0.06895290632160778,-0.11604273212831918,1,TRUE
Sample1,1,1,11299,11337,38,114460000,114840000,380000,-0.06895290632160778,0.07185281014942427,0.14080571647103204,1,TRUE
Sample1,1,-1,11337,11361,24,114840000,115080000,240000,0.07185281014942427,-0.018242080125281456,-0.09009489027470573,1,TRUE
Sample1,1,1,11361,11386,25,115080000,115330000,250000,-0.018242080125281456,0.06438246685353005,0.08262454697881151,1,TRUE
Sample1,1,-1,11386,11413,27,115330000,115600000,270000,0.06438246685353005,-0.016718700071920473,-0.08110116692545052,1,TRUE
Sample1,1,1,11413,11443,30,115600000,115900000,300000,-0.016718700071920473,0.08568173566492837,0.10240043573684884,1,TRUE
Sample1,1,-1,11443,11467,24,115900000,116140000,240000,0.08568173566492837,-0.014340713676840972,-0.10002244934176935,1,TRUE
Sample1,1,1,11467,11482,15,116140000,116290000,150000,-0.014340713676840972,-6.360814236562207e-4,0.01370463225318475,1,FALSE
Sample1,1,-1,11482,11512,30,116290000,116590000,300000,-6.360814236562207e-4,-0.044210455943562495,-0.04357437451990628,1,FALSE
Sample1,1,1,11512,11540,28,116590000,116870000,280000,-0.044210455943562495,0.014154945549473621,0.058365401493036116,1,TRUE
Sample1,1,-1,11540,11569,29,116870000,117160000,290000,0.014154945549473621,-0.049628609684797834,-0.06378355523427146,1,TRUE
Sample1,1,1,11569,11592,23,117160000,117390000,230000,-0.049628609684797834,0.03631346554947208,0.08594207523426992,1,TRUE
Sample1,1,-1,11592,11612,20,117390000,117590000,200000,0.03631346554947208,-0.053851305926598717,-0.0901647714760708,1,TRUE
Sample1,1,1,11612,11652,40,117590000,117990000,400000,-0.053851305926598717,0.08804396415458715,0.14189527008118585,1,TRUE
Sample1,1,-1,11652,11665,13,117990000,118120000,130000,0.08804396415458715,0.07960506962024602,-0.00843889453434113,1,FALSE
Sample1,1,1,11665,11678,13,118120000,118250000,130000,0.07960506962024602,0.0855211811870476,0.00591611156680158,1,FALSE
Sample1,1,-1,11678,11733,55,118250000,118800000,550000,0.0855211811870476,-0.056426897459062174,-0.14194807864610978,1,TRUE
Sample1,1,1,11733,11754,21,118800000,119010000,210000,-0.056426897459062174,0.0011608941766597105,0.057587791635721884,1,TRUE
Sample1,1,-1,11754,11799,45,119010000,119460000,450000,0.0011608941766597105,-0.11885079711386654,-0.12001169129052625,1,TRUE
Sample1,1,1,11799,11827,28,119460000,119740000,280000,-0.11885079711386654,-0.029314044920407942,0.0895367521934586,1,FALSE
Sample1,1,-1,11827,11860,33,119740000,120070000,330000,-0.029314044920407942,-0.06305059611602329,-0.03373655119561535,1,FALSE
Sample1,1,1,11860,11901,41,120070000,125280000,5210000,-0.06305059611602329,0.15482704607102477,0.21787764218704805,0.07869481765834933,TRUE
Sample1,1,-1,11901,11971,70,125280000,145790000,20510000,0.15482704607102477,-0.11825656523084566,-0.2730836113018704,0.034129692832764506,TRUE
Sample1,1,1,11971,12029,58,145790000,147220000,1430000,-0.11825656523084566,0.026703019701108076,0.14495958493195374,0.40559440559440557,TRUE
Sample1,1,-1,12029,12050,21,147220000,147430000,210000,0.026703019701108076,-0.07024323759660499,-0.09694625729771306,1,TRUE
Sample1,1,1,12050,12068,18,147430000,147610000,180000,-0.07024323759660499,0.014064424521138087,0.08430766211774307,1,TRUE
Sample1,1,-1,12068,12107,39,147610000,148000000,390000,0.014064424521138087,-0.06932597022018103,-0.08339039474131911,1,TRUE
Sample1,1,1,12107,12153,46,148000000,149960000,1960000,-0.06932597022018103,-0.02657031021342073,0.0427556600067603,0.23469387755102042,FALSE
Sample1,1,-1,12153,12170,17,149960000,150130000,170000,-0.02657031021342073,-0.04321192188318952,-0.016641611669768793,1,FALSE
Sample1,1,1,12170,12191,21,150130000,150340000,210000,-0.04321192188318952,0.008895059605030679,0.0521069814882202,1,TRUE
Sample1,1,-1,12191,12208,17,150340000,150510000,170000,0.008895059605030679,-0.0328474288853342,-0.04174248849036488,1,TRUE
Sample1,1,1,12208,12224,16,150510000,150670000,160000,-0.0328474288853342,-0.010529782677326592,0.022317646208007608,1,FALSE
Sample1,1,-1,12224,12243,19,150670000,150860000,190000,-0.010529782677326592,-0.044279136447324494,-0.0337493537699979,1,FALSE
Sample1,1,1,12243,12269,26,150860000,151120000,260000,-0.044279136447324494,-0.003190052917294509,0.041089083530029984,1,FALSE
Sample1,1,-1,12269,12287,18,151120000,151300000,180000,-0.003190052917294509,-0.0160471867210666,-0.01285713380377209,1,FALSE
Sample1,1,1,12287,12314,27,151300000,151570000,270000,-0.0160471867210666,0.06837011849986102,0.08441730522092762,1,TRUE
Sample1,1,-1,12314,12340,26,151570000,151830000,260000,0.06837011849986102,-0.07397974633684565,-0.14234986483670667,1,TRUE
Sample1,1,1,12340,12374,34,151830000,152170000,340000,-0.07397974633684565,0.20739630949840843,0.28137605583525405,1,TRUE
Sample1,1,-1,12374,12398,24,152170000,152410000,240000,0.20739630949840843,0.07853130686628407,-0.12886500263212436,1,FALSE
Sample1,1,1,12398,12414,16,152410000,152570000,160000,0.07853130686628407,0.11591632753776875,0.03738502067148468,1,FALSE
Sample1,1,-1,12414,12493,79,152570000,153360000,790000,0.11591632753776875,-0.19601961953512148,-0.31193594707289024,1,TRUE
Sample1,1,1,12493,12533,40,153360000,153760000,400000,-0.19601961953512148,0.09366308505781319,0.28968270459293466,1,TRUE
Sample1,1,-1,12533,12562,29,153760000,154050000,290000,0.09366308505781319,-0.05561892359448643,-0.14928200865229962,1,TRUE
Sample1,1,1,12562,12596,34,154050000,154390000,340000,-0.05561892359448643,0.0315099443111909,0.08712886790567734,1,TRUE
Sample1,1,-1,12596,12647,51,154390000,154900000,510000,0.0315099443111909,-0.08862072925904015,-0.12013067357023105,1,TRUE
Sample1,1,1,12647,12690,43,154900000,155330000,430000,-0.08862072925904015,0.10189696916179236,0.1905176984208325,1,TRUE
Sample1,1,-1,12690,12712,22,155330000,155550000,220000,0.10189696916179236,-0.07689621962739408,-0.17879318878918643,1,TRUE
Sample1,1,1,12712,12722,10,155550000,155650000,100000,-0.07689621962739408,-0.03710465365679841,0.039791565970595674,1,FALSE
Sample1,1,-1,12722,12743,21,155650000,155860000,210000,-0.03710465365679841,-0.11956330304684347,-0.08245864939004506,1,FALSE
Sample1,1,1,12743,12776,33,155860000,156190000,330000,-0.11956330304684347,0.02935809341666478,0.14892139646350824,1,TRUE
Sample1,1,-1,12776,12807,31,156190000,156500000,310000,0.02935809341666478,-0.05288688670880199,-0.08224498012546677,1,TRUE
Sample1,1,1,12807,12884,77,156500000,157270000,770000,-0.05288688670880199,0.19951962788465322,0.2524065145934552,1,TRUE
Sample1,1,-1,12884,12943,59,157270000,157860000,590000,0.19951962788465322,-0.1519175938351951,-0.3514372217198483,1,TRUE
Sample1,1,1,12943,12981,38,157860000,158240000,380000,-0.1519175938351951,0.16782154704033284,0.3197391408755279,1,TRUE
Sample1,1,-1,12981,13062,81,158240000,159050000,810000,0.16782154704033284,-0.10919334562099828,-0.2770148926613311,1,TRUE
Sample1,1,1,13062,13086,24,159050000,159290000,240000,-0.10919334562099828,0.004634781467560285,0.11382812708855856,1,TRUE
Sample1,1,-1,13086,13126,40,159290000,159690000,400000,0.004634781467560285,-0.18820231165140872,-0.192837093118969,1,TRUE
Sample1,1,1,13126,13201,75,159690000,160440000,750000,-0.18820231165140872,0.12258037953945004,0.3107826911908588,1,TRUE
Sample1,1,-1,13201,13253,52,160440000,160960000,520000,0.12258037953945004,-0.1432783676909466,-0.26585874723039665,1,TRUE
Sample1,1,1,13253,13297,44,160960000,161400000,440000,-0.1432783676909466,0.062199477448966894,0.2054778451399135,1,TRUE
Sample1,1,-1,13297,13311,14,161400000,161540000,140000,0.062199477448966894,0.043756277501537176,-0.01844319994742972,1,FALSE
Sample1,1,1,13311,13332,21,161540000,161750000,210000,0.043756277501537176,0.12867487221949547,0.08491859471795829,1,FALSE
Sample1,1,-1,13332,13354,22,161750000,161970000,220000,0.12867487221949547,-0.012872851200811126,-0.1415477234203066,1,TRUE
Sample1,1,1,13354,13373,19,161970000,162160000,190000,-0.012872851200811126,0.14487113208216135,0.15774398328297248,1,TRUE
Sample1,1,-1,13373,13398,25,162160000,162410000,250000,0.14487113208216135,-0.04347426184294664,-0.188345393925108,1,TRUE
Sample1,1,1,13398,13421,23,162410000,162640000,230000,-0.04347426184294664,0.0979695760179801,0.14144383786092674,1,TRUE
Sample1,1,-1,13421,13447,26,162640000,162900000,260000,0.0979695760179801,0.02827257260730456,-0.06969700341067554,1,FALSE
Sample1,1,1,13447,13474,27,162900000,163170000,270000,0.02827257260730456,0.08518120673879015,0.056908634131485586,1,FALSE
Sample1,1,-1,13474,13484,10,163170000,163270000,100000,0.08518120673879015,0.07132402521814962,-0.013857181520640527,1,FALSE
Sample1,1,1,13484,13501,17,163270000,163440000,170000,0.07132402521814962,0.10482333056602705,0.03349930534787743,1,FALSE
Sample1,1,-1,13501,13528,27,163440000,163710000,270000,0.10482333056602705,0.0043635755348668155,-0.10045975503116024,1,FALSE
Sample1,1,1,13528,13549,21,163710000,163920000,210000,0.0043635755348668155,0.05643578188654294,0.05207220635167613,1,FALSE
Sample1,1,-1,13549,13589,40,163920000,164320000,400000,0.05643578188654294,-0.09195989903856422,-0.14839568092510716,1,TRUE
Sample1,1,1,13589,13619,30,164320000,164620000,300000,-0.09195989903856422,0.04978860076726804,0.14174849980583226,1,TRUE
Sample1,1,-1,13619,13709,90,164620000,165520000,900000,0.04978860076726804,-0.1295336603034803,-0.17932226107074833,1,TRUE
Sample1,1,1,13709,13752,43,165520000,165950000,430000,-0.1295336603034803,0.16777340855430417,0.29730706885778446,1,TRUE
Sample1,1,-1,13752,13834,82,165950000,166770000,820000,0.16777340855430417,-0.08332347636193456,-0.2510968849162387,1,TRUE
Sample1,1,1,13834,13849,15,166770000,166920000,150000,-0.08332347636193456,-0.0521527852634987,0.031170691098435857,1,FALSE
Sample1,1,-1,13849,13861,12,166920000,167040000,120000,-0.0521527852634987,-0.07975400460234641,-0.02760121933884771,1,FALSE
Sample1,1,1,13861,13881,20,167040000,167240000,200000,-0.07975400460234641,-0.027712245111245398,0.052041759491101014,1,FALSE
Sample1,1,-1,13881,13898,17,167240000,167410000,170000,-0.027712245111245398,-0.11441108160541222,-0.08669883649416682,1,FALSE
Sample1,1,1,13898,13950,52,167410000,167930000,520000,-0.11441108160541222,0.06349786599159685,0.17790894759700907,1,TRUE
Sample1,1,-1,13950,13967,17,167930000,168100000,170000,0.06349786599159685,0.0029975990671885083,-0.06050026692440834,1,FALSE
Sample1,1,1,13967,13989,22,168100000,168320000,220000,0.0029975990671885083,0.1377426824752278,0.1347450834080393,1,FALSE
Sample1,1,-1,13989,14052,63,168320000,168950000,630000,0.1377426824752278,-0.06457818707584784,-0.20232086955107564,1,TRUE
Sample1,1,1,14052,14074,22,168950000,169170000,220000,-0.06457818707584784,0.046768412689876915,0.11134659976572475,1,TRUE
Sample1,1,-1,14074,14096,22,169170000,169390000,220000,0.046768412689876915,-0.13293432895754648,-0.1797027416474234,1,TRUE
Sample1,1,1,14096,14145,49,169390000,169880000,490000,-0.13293432895754648,0.05310758668118681,0.1860419156387333,1,TRUE
Sample1,1,-1,14145,14162,17,169880000,170050000,170000,0.05310758668118681,-0.007026987482480946,-0.060134574163667756,1,TRUE
Sample1,1,1,14162,14181,19,170050000,170240000,190000,-0.007026987482480946,0.032256822521811425,0.039283810004292374,1,TRUE
Sample1,1,-1,14181,14203,22,170240000,170460000,220000,0.032256822521811425,-0.03896079913282482,-0.07121762165463624,1,TRUE
Sample1,1,1,14203,14231,28,170460000,170740000,280000,-0.03896079913282482,0.07476498987715154,0.11372578900997635,1,TRUE
Sample1,1,-1,14231,14290,59,170740000,171330000,590000,0.07476498987715154,-0.1217537978779076,-0.19651878775505915,1,TRUE
Sample1,1,1,14290,14344,54,171330000,171870000,540000,-0.1217537978779076,0.09771060254259477,0.21946440042050236,1,TRUE
Sample1,1,-1,14344,14390,46,171870000,172330000,460000,0.09771060254259477,-0.03379775874386894,-0.1315083612864637,1,TRUE
Sample1,1,1,14390,14419,29,172330000,172620000,290000,-0.03379775874386894,0.03686614479696843,0.07066390354083738,1,TRUE
Sample1,1,-1,14419,14445,26,172620000,172880000,260000,0.03686614479696843,7.566284234143111e-4,-0.03610951637355412,1,FALSE
Sample1,1,1,14445,14462,17,172880000,173050000,170000,7.566284234143111e-4,0.03498159897576987,0.03422497055235556,1,FALSE
Sample1,1,-1,14462,14494,32,173050000,173370000,320000,0.03498159897576987,-0.10757792837729037,-0.14255952735306024,1,TRUE
Sample1,1,1,14494,14525,31,173370000,173680000,310000,-0.10757792837729037,0.010281270358000397,0.11785919873529077,1,TRUE
Sample1,1,-1,14525,14547,22,173680000,173900000,220000,0.010281270358000397,-0.05640047065141081,-0.06668174100941121,1,TRUE
Sample1,1,1,14547,14590,43,173900000,174330000,430000,-0.05640047065141081,0.2832031043688985,0.3396035750203093,1,TRUE
Sample1,1,-1,14590,14652,62,174330000,174950000,620000,0.2832031043688985,-0.1129338440940749,-0.3961369484629734,1,TRUE
Sample1,1,1,14652,14678,26,174950000,175210000,260000,-0.1129338440940749,0.09536128829745573,0.20829513239153064,1,TRUE
Sample1,1,-1,14678,14728,50,175210000,175710000,500000,0.09536128829745573,-0.07404534953588553,-0.16940663783334126,1,TRUE
Sample1,1,1,14728,14750,22,175710000,175930000,220000,-0.07404534953588553,0.05691122204108153,0.13095657157696705,1,TRUE
Sample1,1,-1,14750,14771,21,175930000,176140000,210000,0.05691122204108153,-0.16643914561030806,-0.2233503676513896,1,TRUE
Sample1,1,1,14771,14795,24,176140000,176380000,240000,-0.16643914561030806,0.11182762690108697,0.27826677251139503,1,TRUE
Sample1,1,-1,14795,14837,42,176380000,176800000,420000,0.11182762690108697,-0.034634669024988365,-0.14646229592607535,1,TRUE
Sample1,1,1,14837,14861,24,176800000,177040000,240000,-0.034634669024988365,0.02126663957895013,0.05590130860393849,1,TRUE
Sample1,1,-1,14861,14942,81,177040000,177850000,810000,0.02126663957895013,-0.2522865413135402,-0.27355318089249037,1,TRUE
Sample1,1,1,14942,14973,31,177850000,178160000,310000,-0.2522865413135402,0.17213253116164326,0.4244190724751835,1,TRUE
Sample1,1,-1,14973,14999,26,178160000,178420000,260000,0.17213253116164326,-0.11286984256850183,-0.2850023737301451,1,TRUE
Sample1,1,1,14999,15024,25,178420000,178670000,250000,-0.11286984256850183,0.07088135495622093,0.18375119752472274,1,TRUE
Sample1,1,-1,15024,15048,24,178670000,178910000,240000,0.07088135495622093,-0.07099887853668074,-0.1418802334929017,1,TRUE
Sample1,1,1,15048,15096,48,178910000,179390000,480000,-0.07099887853668074,0.10626314411979962,0.17726202265648036,1,TRUE
Sample1,1,-1,15096,15132,36,179390000,179750000,360000,0.10626314411979962,-0.09470287697218147,-0.20096602109198108,1,TRUE
Sample1,1,1,15132,15154,22,179750000,179970000,220000,-0.09470287697218147,0.01871179905128547,0.11341467602346694,1,TRUE
Sample1,1,-1,15154,15169,15,179970000,180120000,150000,0.01871179905128547,-0.040030366751215865,-0.058742165802501335,1,TRUE
Sample1,1,1,15169,15186,17,180120000,180290000,170000,-0.040030366751215865,0.0720376727979367,0.11206803954915256,1,TRUE
Sample1,1,-1,15186,15205,19,180290000,180480000,190000,0.0720376727979367,-0.05841758612119305,-0.13045525891912974,1,TRUE
Sample1,1,1,15205,15227,22,180480000,180700000,220000,-0.05841758612119305,0.11282837314216247,0.1712459592633555,1,TRUE
Sample1,1,-1,15227,15251,24,180700000,180940000,240000,0.11282837314216247,-0.06968010173594681,-0.18250847487810928,1,TRUE
Sample1,1,1,15251,15287,36,180940000,181300000,360000,-0.06968010173594681,0.2019634368042103,0.2716435385401571,1,TRUE
Sample1,1,-1,15287,15348,61,181300000,181910000,610000,0.2019634368042103,-0.0807314249537843,-0.28269486175799463,1,TRUE
Sample1,1,1,15348,15371,23,181910000,182140000,230000,-0.0807314249537843,-0.030126055313246764,0.05060536964053754,1,FALSE
Sample1,1,-1,15371,15406,35,182140000,182490000,350000,-0.030126055313246764,-0.11372726051982587,-0.08360120520657911,1,FALSE
Sample1,1,1,15406,15422,16,182490000,182650000,160000,-0.11372726051982587,-0.07586650380565373,0.03786075671417215,1,FALSE
Sample1,1,-1,15422,15437,15,182650000,182800000,150000,-0.07586650380565373,-0.1030445342899168,-0.02717803048426308,1,FALSE
Sample1,1,1,15437,15459,22,182800000,183020000,220000,-0.1030445342899168,0.021507787652842027,0.12455232194275884,1,TRUE
Sample1,1,-1,15459,15470,11,183020000,183130000,110000,0.021507787652842027,-0.006192664103358895,-0.027700451756200922,1,TRUE
Sample1,1,1,15470,15488,18,183130000,183310000,180000,-0.006192664103358895,0.07361783913871818,0.07981050324207707,1,TRUE
Sample1,1,-1,15488,15506,18,183310000,183490000,180000,0.07361783913871818,0.009930005902438251,-0.06368783323627993,1,FALSE
Sample1,1,1,15506,15528,22,183490000,183710000,220000,0.009930005902438251,0.17114335015546622,0.16121334425302797,1,FALSE
Sample1,1,-1,15528,15553,25,183710000,183960000,250000,0.17114335015546622,-0.02080982149615804,-0.19195317165162426,1,TRUE
Sample1,1,1,15553,15582,29,183960000,184250000,290000,-0.02080982149615804,0.052512631081869994,0.07332245257802804,1,TRUE
Sample1,1,-1,15582,15618,36,184250000,184610000,360000,0.052512631081869994,-0.09705765828817206,-0.14957028937004205,1,TRUE
Sample1,1,1,15618,15669,51,184610000,185120000,510000,-0.09705765828817206,0.04510002203085013,0.1421576803190222,1,TRUE
Sample1,1,-1,15669,15691,22,185120000,185340000,220000,0.04510002203085013,-0.034026649227951226,-0.07912667125880135,1,TRUE
Sample1,1,1,15691,15736,45,185340000,185790000,450000,-0.034026649227951226,0.1231937094778846,0.15722035870583584,1,TRUE
Sample1,1,-1,15736,15771,35,185790000,186140000,350000,0.1231937094778846,-0.07425566067980514,-0.19744937015768976,1,TRUE
Sample1,1,1,15771,15797,26,186140000,186400000,260000,-0.07425566067980514,0.054054670654708634,0.12831033133451378,1,TRUE
Sample1,1,-1,15797,15813,16,186400000,186560000,160000,0.054054670654708634,0.043550373777791224,-0.01050429687691741,1,FALSE
Sample1,1,1,15813,15837,24,186560000,186800000,240000,0.043550373777791224,0.08132213476451505,0.03777176098672383,1,FALSE
Sample1,1,-1,15837,15856,19,186800000,186990000,190000,0.08132213476451505,0.062061274559274446,-0.019260860205240607,1,FALSE
Sample1,1,1,15856,15874,18,186990000,187170000,180000,0.062061274559274446,0.0832880805688152,0.021226806009540758,1,FALSE
Sample1,1,-1,15874,15910,36,187170000,187530000,360000,0.0832880805688152,-0.0010012979055297605,-0.08428937847434496,1,TRUE
Sample1,1,1,15910,15922,12,187530000,187650000,120000,-0.0010012979055297605,0.0197940102831422,0.020795308188671962,1,TRUE
Sample1,1,-1,15922,15944,22,187650000,187870000,220000,0.0197940102831422,-0.027624873198042712,-0.04741888348118491,1,TRUE
Sample1,1,1,15944,15970,26,187870000,188130000,260000,-0.027624873198042712,0.010068078994147044,0.03769295219218975,1,TRUE
Sample1,1,-1,15970,15984,14,188130000,188270000,140000,0.010068078994147044,0.004929195985766787,-0.005138883008380257,1,FALSE
Sample1,1,1,15984,16006,22,188270000,188490000,220000,0.004929195985766787,0.03446946620777363,0.029540270222006844,1,FALSE
Sample1,1,-1,16006,16030,24,188490000,188730000,240000,0.03446946620777363,-0.01152702807603062,-0.04599649428380425,1,TRUE
Sample1,1,1,16030,16056,26,188730000,188990000,260000,-0.01152702807603062,0.024911281805916917,0.03643830988194754,1,TRUE
Sample1,1,-1,16056,16108,52,188990000,189510000,520000,0.024911281805916917,-0.09257053996592389,-0.1174818217718408,1,TRUE
Sample1,1,1,16108,16138,30,189510000,189810000,300000,-0.09257053996592389,0.023825900158452897,0.11639644012437679,1,TRUE
Sample1,1,-1,16138,16155,17,189810000,189980000,170000,0.023825900158452897,-0.003542177283446324,-0.02736807744189922,1,TRUE
Sample1,1,1,16155,16173,18,189980000,190160000,180000,-0.003542177283446324,0.07696562624143659,0.08050780352488292,1,TRUE
Sample1,1,-1,16173,16198,25,190160000,190410000,250000,0.07696562624143659,-0.12843413381491692,-0.20539976005635352,1,TRUE
Sample1,1,1,16198,16232,34,190410000,190750000,340000,-0.12843413381491692,0.0910734600465251,0.21950759386144203,1,TRUE
Sample1,1,-1,16232,16297,65,190750000,191400000,650000,0.0910734600465251,-0.05883540862383281,-0.1499088686703579,1,TRUE
Sample1,1,1,16297,16327,30,191400000,191700000,300000,-0.05883540862383281,0.0117555399111889,0.07059094853502171,1,TRUE
Sample1,1,-1,16327,16396,69,191700000,192390000,690000,0.0117555399111889,-0.14303936535908904,-0.15479490527027795,1,TRUE
Sample1,1,1,16396,16417,21,192390000,192600000,210000,-0.14303936535908904,-0.03789782294305607,0.10514154241603296,1,FALSE
Sample1,1,-1,16417,16432,15,192600000,192750000,150000,-0.03789782294305607,-0.09336990092920405,-0.055472077986147984,1,FALSE
Sample1,1,1,16432,16483,51,192750000,193260000,510000,-0.09336990092920405,0.1270685985319814,0.22043849946118546,1,TRUE
Sample1,1,-1,16483,16500,17,193260000,193430000,170000,0.1270685985319814,0.09920212095800351,-0.027866477573977894,1,FALSE
Sample1,1,1,16500,16510,10,193430000,193530000,100000,0.09920212095800351,0.10705280737085889,0.00785068641285537,1,FALSE
Sample1,1,-1,16510,16549,39,193530000,193920000,390000,0.10705280737085889,-0.028922581743589377,-0.13597538911444826,1,TRUE
Sample1,1,1,16549,16575,26,193920000,194180000,260000,-0.028922581743589377,0.012285957174246149,0.041208538917835526,1,TRUE
Sample1,1,-1,16575,16585,10,194180000,194280000,100000,0.012285957174246149,0.00373941554814344,-0.008546541626102709,1,FALSE
Sample1,1,1,16585,16604,19,194280000,194470000,190000,0.00373941554814344,0.042640011743987814,0.03890059619584437,1,FALSE
Sample1,1,-1,16604,16624,20,194470000,194670000,200000,0.042640011743987814,2.2381494581928674e-4,-0.04241619679816853,1,FALSE
Sample1,1,1,16624,16666,42,194670000,195090000,420000,2.2381494581928674e-4,0.024509857477594876,0.02428604253177559,1,FALSE
Sample1,1,-1,16666,16721,55,195090000,195640000,550000,0.024509857477594876,-0.06793907615789575,-0.09244893363549063,1,TRUE
Sample1,1,1,16721,16746,25,195640000,195890000,250000,-0.06793907615789575,0.004579915562257029,0.07251899172015278,1,TRUE
Sample1,1,-1,16746,16764,18,195890000,196070000,180000,0.004579915562257029,-0.04351652101268461,-0.04809643657494164,1,TRUE
Sample1,1,1,16764,16781,17,196070000,196240000,170000,-0.04351652101268461,-0.013586059483863714,0.0299304615288209,1,FALSE
Sample1,1,-1,16781,16820,39,196240000,196630000,390000,-0.013586059483863714,-0.0839699981080235,-0.07038393862415979,1,FALSE
Sample1,1,1,16820,16834,14,196630000,196770000,140000,-0.0839699981080235,-0.06455968215807774,0.01941031594994576,1,FALSE
Sample1,1,-1,16834,16848,14,196770000,196910000,140000,-0.06455968215807774,-0.07797338150836249,-0.013413699350284747,1,FALSE
Sample1,1,1,16848,16908,60,196910000,197510000,600000,-0.07797338150836249,0.04739049876283701,0.1253638802711995,1,TRUE
Sample1,1,-1,16908,16930,22,197510000,197730000,220000,0.04739049876283701,-0.11972188483889439,-0.1671123836017314,1,TRUE
Sample1,1,1,16930,16972,42,197730000,198150000,420000,-0.11972188483889439,0.010601193082492577,0.13032307792138698,1,TRUE
Sample1,1,-1,16972,16990,18,198150000,198330000,180000,0.010601193082492577,-0.05852694613795593,-0.0691281392204485,1,TRUE
Sample1,1,1,16990,17031,41,198330000,198740000,410000,-0.05852694613795593,0.04086128810907662,0.09938823424703255,1,TRUE
Sample1,1,-1,17031,17048,17,198740000,198910000,170000,0.04086128810907662,-0.021652211085418024,-0.06251349919449464,1,TRUE
Sample1,1,1,17048,17066,18,198910000,199090000,180000,-0.021652211085418024,0.02721802748926006,0.04887023857467808,1,TRUE
Sample1,1,-1,17066,17110,44,199090000,199530000,440000,0.02721802748926006,-0.0887280410496783,-0.11594606853893835,1,TRUE
Sample1,1,1,17110,17124,14,199530000,199670000,140000,-0.0887280410496783,-0.06619637666032721,0.022531664389351086,1,FALSE
Sample1,1,-1,17124,17139,15,199670000,199820000,150000,-0.06619637666032721,-0.08382018318844846,-0.017623806528121247,1,FALSE
Sample1,1,1,17139,17161,22,199820000,200040000,220000,-0.08382018318844846,0.052453171124761486,0.13627335431320994,1,TRUE
Sample1,1,-1,17161,17182,21,200040000,200250000,210000,0.052453171124761486,-0.08229321845884795,-0.13474638958360943,1,TRUE
Sample1,1,1,17182,17233,51,200250000,200760000,510000,-0.08229321845884795,0.05978762031014088,0.14208083876898883,1,TRUE
Sample1,1,-1,17233,17255,22,200760000,200980000,220000,0.05978762031014088,-0.03919884671266087,-0.09898646702280176,1,TRUE
Sample1,1,1,17255,17277,22,200980000,201200000,220000,-0.03919884671266087,0.013326863424582919,0.05252571013724379,1,TRUE
Sample1,1,-1,17277,17295,18,201200000,201380000,180000,0.013326863424582919,-0.04583733896193391,-0.05916420238651683,1,TRUE
Sample1,1,1,17295,17319,24,201380000,201620000,240000,-0.04583733896193391,0.05371061449370302,0.09954795345563694,1,TRUE
Sample1,1,-1,17319,17338,19,201620000,201810000,190000,0.05371061449370302,-0.03211337436880425,-0.08582398886250728,1,TRUE
Sample1,1,1,17338,17360,22,201810000,202030000,220000,-0.03211337436880425,0.06621479263632563,0.09832816700512988,1,TRUE
Sample1,1,-1,17360,17376,16,202030000,202190000,160000,0.06621479263632563,0.031270302102690994,-0.03494449053363463,1,FALSE
Sample1,1,1,17376,17391,15,202190000,202340000,150000,0.031270302102690994,0.09482407149768152,0.06355376939499052,1,FALSE
Sample1,1,-1,17391,17414,23,202340000,202570000,230000,0.09482407149768152,-0.08359387609260684,-0.17841794759028834,1,TRUE
Sample1,1,1,17414,17426,12,202570000,202690000,120000,-0.08359387609260684,-0.04230300976718754,0.0412908663254193,1,FALSE
Sample1,1,-1,17426,17439,13,202690000,202820000,130000,-0.04230300976718754,-0.055759317729027334,-0.013456307961839796,1,FALSE
Sample1,1,1,17439,17458,19,202820000,203010000,190000,-0.055759317729027334,0.009314560690532995,0.06507387841956033,1,TRUE
Sample1,1,-1,17458,17476,18,203010000,203190000,180000,0.009314560690532995,-0.011562002680247943,-0.020876563370780938,1,TRUE
Sample1,1,1,17476,17489,13,203190000,203320000,130000,-0.011562002680247943,0.006630387561526901,0.018192390241774846,1,TRUE
Sample1,1,-1,17489,17499,10,203320000,203420000,100000,0.006630387561526901,-0.005212924922163116,-0.011843312483690017,1,TRUE
Sample1,1,1,17499,17525,26,203420000,203680000,260000,-0.005212924922163116,0.0765980199020545,0.08181094482421762,1,TRUE
Sample1,1,-1,17525,17570,45,203680000,204130000,450000,0.0765980199020545,-0.004111882782590519,-0.08070990268464502,1,TRUE
Sample1,1,1,17570,17580,10,204130000,204230000,100000,-0.004111882782590519,0.008108095284821468,0.012219978067411987,1,TRUE
Sample1,1,-1,17580,17597,17,204230000,204400000,170000,0.008108095284821468,-0.009152195764765319,-0.017260291049586787,1,TRUE
Sample1,1,1,17597,17638,41,204400000,204810000,410000,-0.009152195764765319,0.06486255579899719,0.07401475156376251,1,TRUE
Sample1,1,-1,17638,17676,38,204810000,205190000,380000,0.06486255579899719,-0.06819770547584657,-0.13306026127484377,1,TRUE
Sample1,1,1,17676,17698,22,205190000,205410000,220000,-0.06819770547584657,0.0018555231929993574,0.07005322866884592,1,TRUE
Sample1,1,-1,17698,17713,15,205410000,205560000,150000,0.0018555231929993574,-0.0274992835769323,-0.029354806769931657,1,TRUE
Sample1,1,1,17713,17745,32,205560000,205880000,320000,-0.0274992835769323,0.07488235983293638,0.10238164340986869,1,TRUE
Sample1,1,-1,17745,17775,30,205880000,206400000,520000,0.07488235983293638,-0.07757183550386806,-0.15245419533680443,0.5769230769230769,TRUE
Sample1,1,1,17775,17806,31,206400000,206710000,310000,-0.07757183550386806,0.1057408268091548,0.18331266231302284,1,TRUE
Sample1,1,-1,17806,17827,21,206710000,206920000,210000,0.1057408268091548,0.03269812277368758,-0.07304270403546721,1,FALSE
Sample1,1,1,17827,17842,15,206920000,207070000,150000,0.03269812277368758,0.07106556199097674,0.03836743921728916,1,FALSE
Sample1,1,-1,17842,17889,47,207070000,207540000,470000,0.07106556199097674,-0.05894614984377042,-0.13001171183474716,1,TRUE
Sample1,1,1,17889,17940,51,207540000,208050000,510000,-0.05894614984377042,0.12765618378007101,0.18660233362384143,1,TRUE
Sample1,1,-1,17940,18007,67,208050000,208720000,670000,0.12765618378007101,-0.009458128112214087,-0.1371143118922851,1,TRUE
Sample1,1,1,18007,18026,19,208720000,208910000,190000,-0.009458128112214087,0.011764721687827204,0.021222849800041292,1,TRUE
Sample1,1,-1,18026,18099,73,208910000,209640000,730000,0.011764721687827204,-0.14085857697446236,-0.15262329866228957,1,TRUE
Sample1,1,1,18099,18128,29,209640000,209930000,290000,-0.14085857697446236,0.06719189852318612,0.2080504754976485,1,TRUE
Sample1,1,-1,18128,18151,23,209930000,210160000,230000,0.06719189852318612,-0.0666771778783593,-0.13386907640154544,1,TRUE
Sample1,1,1,18151,18182,31,210160000,210470000,310000,-0.0666771778783593,0.15569247423634439,0.2223696521147037,1,TRUE
Sample1,1,-1,18182,18241,59,210470000,211060000,590000,0.15569247423634439,-0.16557329049059322,-0.3212657647269376,1,TRUE
Sample1,1,1,18241,18268,27,211060000,211330000,270000,-0.16557329049059322,-0.03620887908421048,0.12936441140638275,1,FALSE
Sample1,1,-1,18268,18289,21,211330000,211540000,210000,-0.03620887908421048,-0.06605630755366747,-0.02984742846945699,1,FALSE
Sample1,1,1,18289,18324,35,211540000,211890000,350000,-0.06605630755366747,0.07809446572868087,0.14415077328234832,1,TRUE
Sample1,1,-1,18324,18354,30,211890000,212190000,300000,0.07809446572868087,-0.08659211031539707,-0.16468657604407794,1,TRUE
Sample1,1,1,18354,18407,53,212190000,212720000,530000,-0.08659211031539707,0.050007275810061945,0.13659938612545902,1,TRUE
Sample1,1,-1,18407,18420,13,212720000,212850000,130000,0.050007275810061945,0.034290530406056424,-0.01571674540400552,1,FALSE
Sample1,1,1,18420,18450,30,212850000,213150000,300000,0.034290530406056424,0.16621418107102973,0.1319236506649733,1,FALSE
Sample1,1,-1,18450,18546,96,213150000,214110000,960000,0.16621418107102973,-0.13599598589255596,-0.3022101669635857,1,TRUE
Sample1,1,1,18546,18567,21,214110000,214320000,210000,-0.13599598589255596,-0.015169508392384307,0.12082647750017166,1,FALSE
Sample1,1,-1,18567,18582,15,214320000,214470000,150000,-0.015169508392384307,-0.12465839646400971,-0.1094888880716254,1,FALSE
Sample1,1,1,18582,18607,25,214470000,214720000,250000,-0.12465839646400971,0.19828248537889906,0.32294088184290876,1,TRUE
Sample1,1,-1,18607,18637,30,214720000,215020000,300000,0.19828248537889906,0.0677512158909513,-0.13053126948794774,1,FALSE
Sample1,1,1,18637,18647,10,215020000,215120000,100000,0.0677512158909513,0.07310381349325104,0.0053525976022997385,1,FALSE
Sample1,1,-1,18647,18683,36,215120000,215480000,360000,0.07310381349325104,-0.03313537005301454,-0.10623918354626558,1,TRUE
Sample1,1,1,18683,18707,24,215480000,215720000,240000,-0.03313537005301454,0.16069161905384718,0.19382698910686172,1,TRUE
Sample1,1,-1,18707,18734,27,215720000,215990000,270000,0.16069161905384718,0.011162445388414908,-0.14952917366543228,1,FALSE
Sample1,1,1,18734,18744,10,215990000,216090000,100000,0.011162445388414908,0.019823623879922335,0.008661178491507427,1,FALSE
Sample1,1,-1,18744,18779,35,216090000,216440000,350000,0.019823623879922335,-0.08372653534053574,-0.10355015922045807,1,TRUE
Sample1,1,1,18779,18829,50,216440000,216940000,500000,-0.08372653534053574,0.022617732239464054,0.10634426757999979,1,TRUE
Sample1,1,-1,18829,18862,33,216940000,217270000,330000,0.022617732239464054,-0.10348116406685372,-0.12609889630631776,1,TRUE
Sample1,1,1,18862,18884,22,217270000,217490000,220000,-0.10348116406685372,-0.02690995815773389,0.07657120590911982,1,FALSE
Sample1,1,-1,18884,18899,15,217490000,217640000,150000,-0.02690995815773389,-0.05313420163773995,-0.02622424348000606,1,FALSE
Sample1,1,1,18899,18913,14,217640000,217780000,140000,-0.05313420163773995,-0.03426127794173332,0.018872923696006627,1,FALSE
Sample1,1,-1,18913,18944,31,217780000,218090000,310000,-0.03426127794173332,-0.10535206547296751,-0.07109078753123418,1,FALSE
Sample1,1,1,18944,18993,49,218090000,218580000,490000,-0.10535206547296751,0.06795730811501113,0.17330937358797865,1,TRUE
Sample1,1,-1,18993,19010,17,218580000,218750000,170000,0.06795730811501113,0.003130099605910753,-0.06482720850910038,1,FALSE
Sample1,1,1,19010,19023,13,218750000,218880000,130000,0.003130099605910753,0.019831524121692732,0.01670142451578198,1,FALSE
Sample1,1,-1,19023,19038,15,218880000,219030000,150000,0.019831524121692732,-0.0013165710404645754,-0.021148095162157307,1,TRUE
Sample1,1,1,19038,19056,18,219030000,219210000,180000,-0.0013165710404645754,0.07015374794262941,0.07147031898309399,1,TRUE
Sample1,1,-1,19056,19078,22,219210000,219430000,220000,0.07015374794262941,-0.031168240306515813,-0.10132198824914522,1,TRUE
Sample1,1,1,19078,19096,18,219430000,219610000,180000,-0.031168240306515813,0.03182431569842835,0.06299255600494416,1,TRUE
Sample1,1,-1,19096,19116,20,219610000,219810000,200000,0.03182431569842835,-0.07258504067760564,-0.10440935637603399,1,TRUE
Sample1,1,1,19116,19143,27,219810000,220080000,270000,-0.07258504067760564,0.04510504616260815,0.11769008684021379,1,TRUE
Sample1,1,-1,19143,19158,15,220080000,220230000,150000,0.04510504616260815,0.01648703984735535,-0.0286180063152528,1,FALSE
Sample1,1,1,19158,19179,21,220230000,220440000,210000,0.01648703984735535,0.06850558397950748,0.052018544132152136,1,FALSE
Sample1,1,-1,19179,19202,23,220440000,220670000,230000,0.06850558397950748,-0.04602244071924063,-0.11452802469874812,1,TRUE
Sample1,1,1,19202,19226,24,220670000,220910000,240000,-0.04602244071924063,0.08352500752994677,0.1295474482491874,1,TRUE
Sample1,1,-1,19226,19269,43,220910000,221340000,430000,0.08352500752994677,-0.10193075176841306,-0.18545575929835983,1,TRUE
Sample1,1,1,19269,19314,45,221340000,221790000,450000,-0.10193075176841306,0.03476566570833592,0.136696417476749,1,TRUE
Sample1,1,-1,19314,19371,57,221790000,222360000,570000,0.03476566570833592,-0.17690059300413363,-0.21166625871246955,1,TRUE
Sample1,1,1,19371,19415,44,222360000,222800000,440000,-0.17690059300413363,0.0521048173818351,0.22900541038596872,1,TRUE
Sample1,1,-1,19415,19436,21,222800000,223010000,210000,0.0521048173818351,-0.03326832566791211,-0.08537314304974722,1,TRUE
Sample1,1,1,19436,19455,19,223010000,223200000,190000,-0.03326832566791211,0.07279264514718804,0.10606097081510016,1,TRUE
Sample1,1,-1,19455,19489,34,223200000,223540000,340000,0.07279264514718804,-0.13684037039022606,-0.2096330155374141,1,TRUE
Sample1,1,1,19489,19561,72,223540000,224320000,780000,-0.13684037039022606,0.07289546340920863,0.2097358337994347,0.9230769230769231,TRUE
Sample1,1,-1,19561,19571,10,224320000,224420000,100000,0.07289546340920863,0.06289687983129538,-0.00999858357791325,1,FALSE
Sample1,1,1,19571,19587,16,224420000,224580000,160000,0.06289687983129538,0.07659146741575676,0.013694587584461376,1,FALSE
Sample1,1,-1,19587,19607,20,224580000,224780000,200000,0.07659146741575676,0.019729447656244986,-0.05686201975951177,1,FALSE
Sample1,1,1,19607,19628,21,224780000,224990000,210000,0.019729447656244986,0.16485285668197996,0.14512340902573498,1,FALSE
Sample1,1,-1,19628,19658,30,224990000,225290000,300000,0.16485285668197996,-0.16463260690563053,-0.3294854635876105,1,TRUE
Sample1,1,1,19658,19679,21,225290000,225500000,210000,-0.16463260690563053,-0.03529953615843528,0.12933307074719524,1,FALSE
Sample1,1,-1,19679,19693,14,225500000,225640000,140000,-0.03529953615843528,-0.0632390763872741,-0.02793954022883883,1,FALSE
Sample1,1,1,19693,19710,17,225640000,225810000,170000,-0.0632390763872741,-0.028940102531214495,0.03429897385605961,1,FALSE
Sample1,1,-1,19710,19721,11,225810000,225920000,110000,-0.028940102531214495,-0.05296348791879677,-0.024023385387582277,1,FALSE
Sample1,1,1,19721,19770,49,225920000,226410000,490000,-0.05296348791879677,0.04877911303406861,0.10174260095286539,1,TRUE
Sample1,1,-1,19770,19796,26,226410000,226670000,260000,0.04877911303406861,-0.03951144479102178,-0.08829055782509039,1,TRUE
Sample1,1,1,19796,19828,32,226670000,226990000,320000,-0.03951144479102178,0.16998916291536867,0.20950060770639045,1,TRUE
Sample1,1,-1,19828,19856,28,226990000,227270000,280000,0.16998916291536867,-0.13554187846210755,-0.3055310413774762,1,TRUE
Sample1,1,1,19856,19882,26,227270000,227530000,260000,-0.13554187846210755,0.025986494827647512,0.16152837328975506,1,TRUE
Sample1,1,-1,19882,19905,23,227530000,227760000,230000,0.025986494827647512,-0.07755494950876718,-0.10354144433641468,1,TRUE
Sample1,1,1,19905,19952,47,227760000,228230000,470000,-0.07755494950876718,0.02954539833204116,0.10710034784080834,1,TRUE
Sample1,1,-1,19952,19966,14,228230000,228370000,140000,0.02954539833204116,0.005444344388525429,-0.024101053943515728,1,FALSE
Sample1,1,1,19966,19995,29,228370000,228660000,290000,0.005444344388525429,0.11011793774690541,0.10467359335837999,1,FALSE
Sample1,1,-1,19995,20046,51,228660000,229170000,510000,0.11011793774690541,-0.11876847776794212,-0.22888641551484754,1,TRUE
Sample1,1,1,20046,20101,55,229170000,229720000,550000,-0.11876847776794212,0.13115133819678,0.24991981596472213,1,TRUE
Sample1,1,-1,20101,20125,24,229720000,229960000,240000,0.13115133819678,-0.005799422093234742,-0.13695076029001474,1,TRUE
Sample1,1,1,20125,20139,14,229960000,230100000,140000,-0.005799422093234742,0.04708059115764735,0.052880013250882096,1,TRUE
Sample1,1,-1,20139,20156,17,230100000,230270000,170000,0.04708059115764735,-0.012965308203353098,-0.06004589936100045,1,TRUE
Sample1,1,1,20156,20170,14,230270000,230410000,140000,-0.012965308203353098,0.02984986772521097,0.04281517592856407,1,TRUE
Sample1,1,-1,20170,20189,19,230410000,230600000,190000,0.02984986772521097,-0.049918278063942605,-0.07976814578915357,1,TRUE
Sample1,1,1,20189,20220,31,230600000,230910000,310000,-0.049918278063942605,0.004302627145627598,0.0542209052095702,1,TRUE
Sample1,1,-1,20220,20258,38,230910000,231290000,380000,0.004302627145627598,-0.05980472853061283,-0.06410735567624043,1,TRUE
Sample1,1,1,20258,20301,43,231290000,231720000,430000,-0.05980472853061283,0.20450602851178673,0.2643107570423996,1,TRUE
Sample1,1,-1,20301,20340,39,231720000,232110000,390000,0.20450602851178673,-0.0033702999638071463,-0.20787632847559387,1,TRUE
Sample1,1,1,20340,20364,24,232110000,232350000,240000,-0.0033702999638071463,0.01859863320787196,0.021968933171679104,1,TRUE
Sample1,1,-1,20364,20388,24,232350000,232590000,240000,0.01859863320787196,-0.1406409783122782,-0.15923961152015015,1,TRUE
Sample1,1,1,20388,20431,43,232590000,233020000,430000,-0.1406409783122782,0.024495355076337384,0.16513633338861558,1,TRUE
Sample1,1,-1,20431,20455,24,233020000,233260000,240000,0.024495355076337384,-0.06709634912406343,-0.0915917042004008,1,TRUE
Sample1,1,1,20455,20480,25,233260000,233510000,250000,-0.06709634912406343,0.10092630527688888,0.16802265440095232,1,TRUE
Sample1,1,-1,20480,20565,85,233510000,234360000,850000,0.10092630527688888,-0.16804156770100515,-0.26896787297789404,1,TRUE
Sample1,1,1,20565,20601,36,234360000,234720000,360000,-0.16804156770100515,0.015158662418961865,0.183200230119967,1,TRUE
Sample1,1,-1,20601,20622,21,234720000,234930000,210000,0.015158662418961865,-0.02304992429885535,-0.03820858671781721,1,TRUE
Sample1,1,1,20622,20639,17,234930000,235100000,170000,-0.02304992429885535,0.040325703078766977,0.06337562737762233,1,TRUE
Sample1,1,-1,20639,20660,21,235100000,235310000,210000,0.040325703078766977,-0.06398537221627407,-0.10431107529504105,1,TRUE
Sample1,1,1,20660,20680,20,235310000,235510000,200000,-0.06398537221627407,0.009900144102467102,0.07388551631874117,1,TRUE
Sample1,1,-1,20680,20707,27,235510000,235780000,270000,0.009900144102467102,-0.06320970629965134,-0.07310985040211844,1,TRUE
Sample1,1,1,20707,20743,36,235780000,236140000,360000,-0.06320970629965134,0.07954456788648061,0.14275427418613196,1,TRUE
Sample1,1,-1,20743,20768,25,236140000,236390000,250000,0.07954456788648061,-0.010955255609096645,-0.09049982349557725,1,TRUE
Sample1,1,1,20768,20837,69,236390000,237080000,690000,-0.010955255609096645,0.11883186647532398,0.12978712208442061,1,TRUE
Sample1,1,-1,20837,20901,64,237080000,237720000,640000,0.11883186647532398,-0.03524823093658779,-0.15408009741191178,1,TRUE
Sample1,1,1,20901,20944,43,237720000,238150000,430000,-0.03524823093658779,0.016431320392527336,0.05167955132911513,1,TRUE
Sample1,1,-1,20944,20978,34,238150000,238490000,340000,0.016431320392527336,-0.0701658356311235,-0.08659715602365084,1,TRUE
Sample1,1,1,20978,21005,27,238490000,238760000,270000,-0.0701658356311235,0.06762501503664511,0.1377908506677686,1,TRUE
Sample1,1,-1,21005,21045,40,238760000,239160000,400000,0.06762501503664511,-0.046694304318078604,-0.11431931935472373,1,TRUE
Sample1,1,1,21045,21074,29,239160000,239450000,290000,-0.046694304318078604,0.040054596008741596,0.0867489003268202,1,TRUE
Sample1,1,-1,21074,21106,32,239450000,239770000,320000,0.040054596008741596,-0.101360768071316,-0.1414153640800576,1,TRUE
Sample1,1,1,21106,21144,38,239770000,240150000,380000,-0.101360768071316,0.06733241855021423,0.1686931866215302,1,TRUE
Sample1,1,-1,21144,21169,25,240150000,240400000,250000,0.06733241855021423,-0.04919451744419594,-0.11652693599441016,1,TRUE
Sample1,1,1,21169,21193,24,240400000,240640000,240000,-0.04919451744419594,0.04962774705882047,0.0988222645030164,1,TRUE
Sample1,1,-1,21193,21262,69,240640000,241330000,690000,0.04962774705882047,-0.12070202779010165,-0.17032977484892212,1,TRUE
Sample1,1,1,21262,21297,35,241330000,241680000,350000,-0.12070202779010165,-0.006655044647617812,0.11404698314248385,1,FALSE
Sample1,1,-1,21297,21309,12,241680000,241800000,120000,-0.006655044647617812,-0.05164265810738359,-0.04498761345976578,1,FALSE
Sample1,1,1,21309,21341,32,241800000,242120000,320000,-0.05164265810738359,0.20026614732730508,0.2519088054346887,1,TRUE
Sample1,1,-1,21341,21418,77,242120000,242890000,770000,0.20026614732730508,-0.09335925981516693,-0.293625407142472,1,TRUE
Sample1,1,1,21418,21435,17,242890000,243290000,400000,-0.09335925981516693,0.08355131475273861,0.17691057456790554,0.425,TRUE
Sample1,1,-1,21435,21480,45,243290000,243740000,450000,0.08355131475273861,-0.15187767824018775,-0.23542899299292636,1,TRUE
Sample1,1,1,21480,21505,25,243740000,243990000,250000,-0.15187767824018775,0.0874616896870839,0.23933936792727165,1,TRUE
Sample1,1,-1,21505,21530,25,243990000,244240000,250000,0.0874616896870839,-0.03831182914281361,-0.1257735188298975,1,TRUE
Sample1,1,1,21530,21545,15,244240000,244390000,150000,-0.03831182914281361,-0.013568414999964409,0.024743414142849196,1,FALSE
Sample1,1,-1,21545,21568,23,244390000,244620000,230000,-0.013568414999964409,-0.07835319252297378,-0.06478477752300937,1,FALSE
Sample1,1,1,21568,21626,58,244620000,245200000,580000,-0.07835319252297378,0.14008288294537385,0.21843607546834765,1,TRUE
Sample1,1,-1,21626,21654,28,245200000,245480000,280000,0.14008288294537385,0.031237185731420754,-0.1088456972139531,1,FALSE
Sample1,1,1,21654,21684,30,245480000,245780000,300000,0.031237185731420754,0.151178393095076,0.11994120736365524,1,FALSE
Sample1,1,-1,21684,21743,59,245780000,246370000,590000,0.151178393095076,-0.1993243883309569,-0.35050278142603286,1,TRUE
Sample1,1,1,21743,21793,50,246370000,246870000,500000,-0.1993243883309569,0.053891730214546685,0.2532161185455036,1,TRUE
Sample1,1,-1,21793,21812,19,246870000,247060000,190000,0.053891730214546685,-0.008875321540982844,-0.06276705175552953,1,TRUE
Sample1,1,1,21812,21833,21,247060000,247270000,210000,-0.008875321540982844,0.03653276107021302,0.04540808261119586,1,TRUE
Sample1,1,-1,21833,21847,14,247270000,247410000,140000,0.03653276107021302,0.026235320691437424,-0.010297440378775596,1,FALSE
Sample1,1,1,21847,21864,17,247410000,247580000,170000,0.026235320691437424,0.040415584453882866,0.014180263762445442,1,FALSE
Sample1,1,-1,21864,21878,14,247580000,247720000,140000,0.040415584453882866,0.032570904778259586,-0.00784467967562328,1,FALSE
Sample1,1,1,21878,21899,21,247720000,247930000,210000,0.032570904778259586,0.08748196007505343,0.05491105529679385,1,FALSE
Sample1,1,-1,21899,21960,61,247930000,248690000,760000,0.08748196007505343,-0.15019324322339847,-0.2376752032984519,0.8026315789473685,TRUE
Sample2,1,1,1,49,48,530000,1090000,560000,-0.4007462147537146,0.011994003813636293,0.4127402185673509,0.8571428571428571,TRUE
Sample2,1,-1,49,70,21,1090000,1300000,210000,0.011994003813636293,-0.15524764450020923,-0.16724164831384553,1,TRUE
Sample2,1,1,70,88,18,1300000,1480000,180000,-0.15524764450020923,-0.006849435631968557,0.14839820886824068,1,FALSE
Sample2,1,-1,88,113,25,1480000,1730000,250000,-0.006849435631968557,-0.05010988917319894,-0.043260453541230384,1,FALSE
Sample2,1,1,113,141,28,1730000,2010000,280000,-0.05010988917319894,0.19099052126445507,0.241100410437654,1,TRUE
Sample2,1,-1,141,182,41,2010000,2420000,410000,0.19099052126445507,0.03852889809020203,-0.15246162317425305,1,FALSE
Sample2,1,1,182,206,24,2420000,2660000,240000,0.03852889809020203,0.3728859044627095,0.3343570063725075,1,FALSE
Sample2,1,-1,206,269,63,2660000,3310000,650000,0.3728859044627095,-0.4916741994280831,-0.8645601038907926,0.9692307692307692,TRUE
Sample2,1,1,269,336,67,3310000,3980000,670000,-0.4916741994280831,0.5257715856140479,1.017445785042131,1,TRUE
Sample2,1,-1,336,404,68,3980000,4660000,680000,0.5257715856140479,0.119224979326059,-0.4065466062879889,1,FALSE
Sample2,1,1,404,419,15,4660000,4810000,150000,0.119224979326059,0.15271527923739664,0.033490299911337645,1,FALSE
Sample2,1,-1,419,521,102,4810000,5830000,1020000,0.15271527923739664,-0.46541397223229636,-0.618129251469693,1,TRUE
Sample2,1,1,521,609,88,5830000,6710000,880000,-0.46541397223229636,0.34276759663663103,0.8081815688689273,1,TRUE
Sample2,1,-1,609,659,50,6710000,7210000,500000,0.34276759663663103,-0.22212458970175072,-0.5648921863383818,1,TRUE
Sample2,1,1,659,681,22,7210000,7430000,220000,-0.22212458970175072,0.020520904647057477,0.2426454943488082,1,TRUE
Sample2,1,-1,681,731,50,7430000,7930000,500000,0.020520904647057477,-0.23516250480296041,-0.2556834094500179,1,TRUE
Sample2,1,1,731,779,48,7930000,8410000,480000,-0.23516250480296041,0.3175491966318565,0.5527117014348168,1,TRUE
Sample2,1,-1,779,809,30,8410000,8710000,300000,0.3175491966318565,-0.4128426205680752,-0.7303918171999317,1,TRUE
Sample2,1,1,809,835,26,8710000,8970000,260000,-0.4128426205680752,0.1516396122595275,0.5644822328276027,1,TRUE
Sample2,1,-1,835,852,17,8970000,9140000,170000,0.1516396122595275,-0.044727322318491594,-0.19636693457801907,1,TRUE
Sample2,1,1,852,868,16,9140000,9300000,160000,-0.044727322318491594,0.047934639859245405,0.092661962177737,1,TRUE
Sample2,1,-1,868,888,20,9300000,9500000,200000,0.047934639859245405,-0.07340086945971684,-0.12133550931896225,1,TRUE
Sample2,1,1,888,904,16,9500000,9660000,160000,-0.07340086945971684,-0.028531274808388372,0.04486959465132847,1,FALSE
Sample2,1,-1,904,914,10,9660000,9760000,100000,-0.028531274808388372,-0.04580809877092294,-0.01727682396253457,1,FALSE
Sample2,1,1,914,944,30,9760000,10060000,300000,-0.04580809877092294,0.14112507369875862,0.18693317246968155,1,TRUE
Sample2,1,-1,944,967,23,10060000,10290000,230000,0.14112507369875862,0.06878556542813893,-0.07233950827061969,1,FALSE
Sample2,1,1,967,988,21,10290000,10500000,210000,0.06878556542813893,0.17340058438498612,0.10461501895684719,1,FALSE
Sample2,1,-1,988,1016,28,10500000,10780000,280000,0.17340058438498612,-0.15578510708336776,-0.32918569146835386,1,TRUE
Sample2,1,1,1016,1057,41,10780000,11190000,410000,-0.15578510708336776,0.17677925249318258,0.33256435957655034,1,TRUE
Sample2,1,-1,1057,1097,40,11190000,11590000,400000,0.17677925249318258,-0.3223175427713706,-0.4990967952645532,1,TRUE
Sample2,1,1,1097,1170,73,11590000,12320000,730000,-0.3223175427713706,0.42041368334886436,0.742731226120235,1,TRUE
Sample2,1,-1,1170,1191,21,12320000,12530000,210000,0.42041368334886436,0.15454368118783715,-0.2658700021610272,1,FALSE
Sample2,1,1,1191,1224,33,12530000,12860000,330000,0.15454368118783715,0.4988946717950376,0.3443509906072004,1,FALSE
Sample2,1,-1,1224,1243,19,12860000,13540000,680000,0.4988946717950376,-0.17636690265298383,-0.6752615744480215,0.27941176470588236,TRUE
Sample2,1,1,1243,1270,27,13540000,13810000,270000,-0.17636690265298383,0.14717286654706885,0.3235397692000527,1,TRUE
Sample2,1,-1,1270,1392,122,13810000,15030000,1220000,0.14717286654706885,-0.39529678226842685,-0.5424696488154956,1,TRUE
Sample2,1,1,1392,1419,27,15030000,15300000,270000,-0.39529678226842685,-0.17732751769470279,0.21796926457372406,1,FALSE
Sample2,1,-1,1419,1435,16,15300000,15460000,160000,-0.17732751769470279,-0.25077546673018086,-0.07344794903547808,1,FALSE
Sample2,1,1,1435,1471,36,15460000,15820000,360000,-0.25077546673018086,0.07935002073005454,0.3301254874602354,1,TRUE
Sample2,1,-1,1471,1493,22,15820000,16040000,220000,0.07935002073005454,-0.14530359520120353,-0.22465361593125807,1,TRUE
Sample2,1,1,1493,1516,23,16040000,16270000,230000,-0.14530359520120353,0.048423168930199566,0.1937267641314031,1,TRUE
Sample2,1,-1,1516,1547,31,16270000,16580000,310000,0.048423168930199566,-0.010495097065478073,-0.058918265995677635,1,TRUE
Sample2,1,1,1547,1598,51,16580000,17090000,510000,-0.010495097065478073,0.26419434175284745,0.2746894388183255,1,TRUE
Sample2,1,-1,1598,1624,26,17090000,17350000,260000,0.26419434175284745,-0.19640610175522558,-0.46060044350807305,1,TRUE
Sample2,1,1,1624,1656,32,17350000,17670000,320000,-0.19640610175522558,0.4664483718472323,0.6628544736024579,1,TRUE
Sample2,1,-1,1656,1737,81,17670000,18480000,810000,0.4664483718472323,-0.37401498905199393,-0.8404633608992262,1,TRUE
Sample2,1,1,1737,1757,20,18480000,18680000,200000,-0.37401498905199393,-0.17935397692849075,0.19466101212350317,1,FALSE
Sample2,1,-1,1757,1774,17,18680000,18850000,170000,-0.17935397692849075,-0.36614828099120195,-0.1867943040627112,1,FALSE
Sample2,1,1,1774,1800,26,18850000,19110000,260000,-0.36614828099120195,-0.026014122174139467,0.3401341588170625,1,FALSE
Sample2,1,-1,1800,1832,32,19110000,19430000,320000,-0.026014122174139467,-0.23368952733374782,-0.20767540515960836,1,FALSE
Sample2,1,1,1832,1881,49,19430000,19920000,490000,-0.23368952733374782,0.43392062440230383,0.6676101517360516,1,TRUE
Sample2,1,-1,1881,1932,51,19920000,20430000,510000,0.43392062440230383,-0.4368330151718038,-0.8707536395741076,1,TRUE
Sample2,1,1,1932,1972,40,20430000,20830000,400000,-0.4368330151718038,0.2125538052323848,0.6493868204041886,1,TRUE
Sample2,1,-1,1972,1998,26,20830000,21090000,260000,0.2125538052323848,-0.3519069405138484,-0.5644607457462332,1,TRUE
Sample2,1,1,1998,2027,29,21090000,21380000,290000,-0.3519069405138484,0.06197255089232461,0.41387949140617303,1,TRUE
Sample2,1,-1,2027,2072,45,21380000,21830000,450000,0.06197255089232461,-0.11822389662843577,-0.1801964475207604,1,TRUE
Sample2,1,1,2072,2104,32,21830000,22150000,320000,-0.11822389662843577,0.3973865703633521,0.5156104669917879,1,TRUE
Sample2,1,-1,2104,2196,92,22150000,23070000,920000,0.3973865703633521,-0.25096488146408064,-0.6483514518274327,1,TRUE
Sample2,1,1,2196,2219,23,23070000,23300000,230000,-0.25096488146408064,-0.021906570429802832,0.22905831103427782,1,FALSE
Sample2,1,-1,2219,2237,18,23300000,23480000,180000,-0.021906570429802832,-0.16346914818251485,-0.14156257775271203,1,FALSE
Sample2,1,1,2237,2262,25,23480000,23730000,250000,-0.16346914818251485,0.15895991884475136,0.3224290670272662,1,TRUE
Sample2,1,-1,2262,2277,15,23730000,23880000,150000,0.15895991884475136,0.046577394640069436,-0.11238252420468192,1,FALSE
Sample2,1,1,2277,2295,18,23880000,24060000,180000,0.046577394640069436,0.13723964507069142,0.09066225043062198,1,FALSE
Sample2,1,-1,2295,2348,53,24060000,24590000,530000,0.13723964507069142,-0.06710833813995402,-0.20434798321064546,1,TRUE
Sample2,1,1,2348,2375,27,24590000,24860000,270000,-0.06710833813995402,0.3203179392560848,0.38742627739603885,1,TRUE
Sample2,1,-1,2375,2411,36,24860000,25220000,360000,0.3203179392560848,-0.2939399868821353,-0.6142579261382202,1,TRUE
Sample2,1,1,2411,2437,26,25220000,25480000,260000,-0.2939399868821353,0.06538092257126668,0.359320909453402,1,TRUE
Sample2,1,-1,2437,2470,33,25480000,25810000,330000,0.06538092257126668,-0.31894979266997614,-0.38433071524124285,1,TRUE
Sample2,1,1,2470,2496,26,25810000,26070000,260000,-0.31894979266997614,0.11083434792307154,0.4297841405930477,1,TRUE
Sample2,1,-1,2496,2521,25,26070000,26320000,250000,0.11083434792307154,-0.12440459169475872,-0.23523893961783027,1,TRUE
Sample2,1,1,2521,2557,36,26320000,26680000,360000,-0.12440459169475872,0.1339765111679574,0.2583811028627161,1,TRUE
Sample2,1,-1,2557,2577,20,26680000,26880000,200000,0.1339765111679574,-0.05776341963550049,-0.1917399308034579,1,TRUE
Sample2,1,1,2577,2595,18,26880000,27060000,180000,-0.05776341963550049,0.11112222877814414,0.16888564841364462,1,TRUE
Sample2,1,-1,2595,2623,28,27060000,27340000,280000,0.11112222877814414,-0.12930261315115302,-0.24042484192929714,1,TRUE
Sample2,1,1,2623,2650,27,27340000,27610000,270000,-0.12930261315115302,0.02820838846249065,0.15751100161364368,1,TRUE
Sample2,1,-1,2650,2663,13,27610000,27740000,130000,0.02820838846249065,-0.010069119166421267,-0.03827750762891192,1,TRUE
Sample2,1,1,2663,2685,22,27740000,27960000,220000,-0.010069119166421267,0.1306325562080931,0.1407016753745144,1,TRUE
Sample2,1,-1,2685,2709,24,27960000,28200000,240000,0.1306325562080931,-0.115184289565441,-0.2458168457735341,1,TRUE
Sample2,1,1,2709,2730,21,28200000,28410000,210000,-0.115184289565441,0.036295462300352646,0.15147975186579365,1,TRUE
Sample2,1,-1,2730,2745,15,28410000,28560000,150000,0.036295462300352646,0.0022950415170125676,-0.03400042078334008,1,FALSE
Sample2,1,1,2745,2773,28,28560000,28840000,280000,0.0022950415170125676,0.2490070761872475,0.24671203467023492,1,FALSE
Sample2,1,-1,2773,2797,24,28840000,29080000,240000,0.2490070761872475,0.08603341613541063,-0.16297366005183686,1,FALSE
Sample2,1,1,2797,2827,30,29080000,29380000,300000,0.08603341613541063,0.4252786300787264,0.33924521394331575,1,FALSE
Sample2,1,-1,2827,2875,48,29380000,29860000,480000,0.4252786300787264,-0.20541364797769204,-0.6306922780564185,1,TRUE
Sample2,1,1,2875,2900,25,29860000,30110000,250000,-0.20541364797769204,0.22029651688097743,0.42571016485866947,1,TRUE
Sample2,1,-1,2900,2948,48,30110000,30590000,480000,0.22029651688097743,-0.4015292507249115,-0.6218257676058889,1,TRUE
Sample2,1,1,2948,2979,31,30590000,30900000,310000,-0.4015292507249115,-0.05541972571381967,0.3461095250110918,1,FALSE
Sample2,1,-1,2979,2992,13,30900000,31030000,130000,-0.05541972571381967,-0.12863606826634033,-0.07321634255252066,1,FALSE
Sample2,1,1,2992,3018,26,31030000,31290000,260000,-0.12863606826634033,0.19653521053227985,0.3251712787986202,1,TRUE
Sample2,1,-1,3018,3050,32,31290000,31610000,320000,0.19653521053227985,-0.25699838180199724,-0.4535335923342771,1,TRUE
Sample2,1,1,3050,3093,43,31610000,32040000,430000,-0.25699838180199724,0.07007090706680474,0.327069288868802,1,TRUE
Sample2,1,-1,3093,3110,17,32040000,32210000,170000,0.07007090706680474,-0.038834496995717005,-0.10890540406252175,1,TRUE
Sample2,1,1,3110,3134,24,32210000,32450000,240000,-0.038834496995717005,0.10458878496730187,0.14342328196301887,1,TRUE
Sample2,1,-1,3134,3155,21,32450000,32660000,210000,0.10458878496730187,-0.07825321541361085,-0.18284200038091272,1,TRUE
Sample2,1,1,3155,3205,50,32660000,33160000,500000,-0.07825321541361085,0.321342986687511,0.39959620210112184,1,TRUE
Sample2,1,-1,3205,3222,17,33160000,33330000,170000,0.321342986687511,0.2135902136718972,-0.10775277301561378,1,FALSE
Sample2,1,1,3222,3261,39,33330000,33720000,390000,0.2135902136718972,0.42158039982995305,0.20799018615805584,1,FALSE
Sample2,1,-1,3261,3349,88,33720000,34600000,880000,0.42158039982995305,-0.5189622373884597,-0.9405426372184127,1,TRUE
Sample2,1,1,3349,3380,31,34600000,34910000,310000,-0.5189622373884597,-0.14478637794066457,0.37417585944779513,1,FALSE
Sample2,1,-1,3380,3394,14,34910000,35050000,140000,-0.14478637794066457,-0.2176065687689896,-0.07282019082832503,1,FALSE
Sample2,1,1,3394,3421,27,35050000,35320000,270000,-0.2176065687689896,0.1452430525782439,0.36284962134723353,1,TRUE
Sample2,1,-1,3421,3443,22,35320000,35540000,220000,0.1452430525782439,-0.1392761616020021,-0.284519214180246,1,TRUE
Sample2,1,1,3443,3479,36,35540000,35900000,360000,-0.1392761616020021,0.02845300544790444,0.16772916704990654,1,TRUE
Sample2,1,-1,3479,3495,16,35900000,36060000,160000,0.02845300544790444,-0.11105638541454002,-0.13950939086244446,1,TRUE
Sample2,1,1,3495,3555,60,36060000,36660000,600000,-0.11105638541454002,0.4897676944939848,0.6008240799085248,1,TRUE
Sample2,1,-1,3555,3619,64,36660000,37300000,640000,0.4897676944939848,-0.48510633963882777,-0.9748740341328126,1,TRUE
Sample2,1,1,3619,3652,33,37300000,37630000,330000,-0.48510633963882777,0.014659418908775368,0.49976575854760313,1,TRUE
Sample2,1,-1,3652,3671,19,37630000,37820000,190000,0.014659418908775368,-0.1200962862931465,-0.13475570520192187,1,TRUE
Sample2,1,1,3671,3710,39,37820000,38210000,390000,-0.1200962862931465,0.4937758236027972,0.6138721098959437,1,TRUE
Sample2,1,-1,3710,3765,55,38210000,38760000,550000,0.4937758236027972,-0.44599103508137894,-0.9397668586841761,1,TRUE
Sample2,1,1,3765,3807,42,38760000,39180000,420000,-0.44599103508137894,0.22377076178009384,0.6697617968614727,1,TRUE
Sample2,1,-1,3807,3832,25,39180000,39430000,250000,0.22377076178009384,-0.2154936990711374,-0.4392644608512313,1,TRUE
Sample2,1,1,3832,3857,25,39430000,39680000,250000,-0.2154936990711374,0.07911843181208152,0.2946121308832189,1,TRUE
Sample2,1,-1,3857,3872,15,39680000,39830000,150000,0.07911843181208152,0.0018148503124779287,-0.07730358149960359,1,FALSE
Sample2,1,1,3872,3894,22,39830000,40050000,220000,0.0018148503124779287,0.15615380352596966,0.15433895321349173,1,FALSE
Sample2,1,-1,3894,3909,15,40050000,40200000,150000,0.15615380352596966,0.049657706963277176,-0.10649609656269249,1,FALSE
Sample2,1,1,3909,3926,17,40200000,40370000,170000,0.049657706963277176,0.1944337898199981,0.14477608285672092,1,FALSE
Sample2,1,-1,3926,3953,27,40370000,40640000,270000,0.1944337898199981,-0.2094906986082884,-0.4039244884282865,1,TRUE
Sample2,1,1,3953,3995,42,40640000,41060000,420000,-0.2094906986082884,0.24219740777685717,0.45168810638514556,1,TRUE
Sample2,1,-1,3995,4017,22,41060000,41280000,220000,0.24219740777685717,-0.05847447394012595,-0.3006718817169831,1,TRUE
Sample2,1,1,4017,4052,35,41280000,41630000,350000,-0.05847447394012595,0.28860798753609956,0.3470824614762255,1,TRUE
Sample2,1,-1,4052,4096,44,41630000,42070000,440000,0.28860798753609956,-0.2328180376666087,-0.5214260252027083,1,TRUE
Sample2,1,1,4096,4137,41,42070000,42480000,410000,-0.2328180376666087,-0.07443954862132837,0.15837848904528032,1,FALSE
Sample2,1,-1,4137,4151,14,42480000,42620000,140000,-0.07443954862132837,-0.1631851228461005,-0.08874557422477214,1,FALSE
Sample2,1,1,4151,4172,21,42620000,42830000,210000,-0.1631851228461005,0.03493783464115691,0.19812295748725742,1,TRUE
Sample2,1,-1,4172,4194,22,42830000,43050000,220000,0.03493783464115691,-0.2216468242482636,-0.2565846588894205,1,TRUE
Sample2,1,1,4194,4256,62,43050000,43670000,620000,-0.2216468242482636,0.22151786777064109,0.4431646920189047,1,TRUE
Sample2,1,-1,4256,4280,24,43670000,43910000,240000,0.22151786777064109,-0.1317756249098996,-0.35329349268054067,1,TRUE
Sample2,1,1,4280,4301,21,43910000,44120000,210000,-0.1317756249098996,0.21263791915254693,0.3444135440624465,1,TRUE
Sample2,1,-1,4301,4349,48,44120000,44600000,480000,0.21263791915254693,-0.24921005301666743,-0.46184797216921436,1,TRUE
Sample2,1,1,4349,4383,34,44600000,44940000,340000,-0.24921005301666743,0.2825805728096825,0.53179062582635,1,TRUE
Sample2,1,-1,4383,4418,35,44940000,45290000,350000,0.2825805728096825,-0.16835467585496527,-0.4509352486646478,1,TRUE
Sample2,1,1,4418,4473,55,45290000,45840000,550000,-0.16835467585496527,0.17456465626181097,0.3429193321167763,1,TRUE
Sample2,1,-1,4473,4498,25,45840000,46090000,250000,0.17456465626181097,-0.307457703987602,-0.48202236024941303,1,TRUE
Sample2,1,1,4498,4568,70,46090000,46790000,700000,-0.307457703987602,0.5010786310778774,0.8085363350654795,1,TRUE
Sample2,1,-1,4568,4603,35,46790000,47140000,350000,0.5010786310778774,-0.4079888462909721,-0.9090674773688495,1,TRUE
Sample2,1,1,4603,4640,37,47140000,47510000,370000,-0.4079888462909721,0.4086501801404049,0.816639026431377,1,TRUE
Sample2,1,-1,4640,4725,85,47510000,48360000,850000,0.4086501801404049,-0.17416147137842655,-0.5828116515188314,1,TRUE
Sample2,1,1,4725,4754,29,48360000,48650000,290000,-0.17416147137842655,0.30157726682818276,0.4757387382066093,1,TRUE
Sample2,1,-1,4754,4887,133,48650000,49980000,1330000,0.30157726682818276,-0.4354362501239991,-0.7370135169521819,1,TRUE
Sample2,1,1,4887,4940,53,49980000,50510000,530000,-0.4354362501239991,0.17936286836781026,0.6147991184918093,1,TRUE
Sample2,1,-1,4940,4972,32,50510000,50830000,320000,0.17936286836781026,-0.4849069845275138,-0.664269852895324,1,TRUE
Sample2,1,1,4972,4999,27,50830000,51100000,270000,-0.4849069845275138,0.02967448177485093,0.5145814663023647,1,TRUE
Sample2,1,-1,4999,5036,37,51100000,51470000,370000,0.02967448177485093,-0.15852897708494793,-0.18820345885979886,1,TRUE
Sample2,1,1,5036,5058,22,51470000,51690000,220000,-0.15852897708494793,0.26147542060022305,0.42000439768517095,1,TRUE
Sample2,1,-1,5058,5085,27,51690000,51960000,270000,0.26147542060022305,-0.17195021996116744,-0.4334256405613905,1,TRUE
Sample2,1,1,5085,5111,26,51960000,52220000,260000,-0.17195021996116744,0.15890168304737096,0.3308519030085384,1,TRUE
Sample2,1,-1,5111,5143,32,52220000,52540000,320000,0.15890168304737096,-0.2708182279091365,-0.42971991095650747,1,TRUE
Sample2,1,1,5143,5177,34,52540000,52880000,340000,-0.2708182279091365,0.18272340831667822,0.4535416362258147,1,TRUE
Sample2,1,-1,5177,5203,26,52880000,53140000,260000,0.18272340831667822,0.025500832448000506,-0.15722257586867772,1,FALSE
Sample2,1,1,5203,5231,28,53140000,53420000,280000,0.025500832448000506,0.19946368940345593,0.17396285695545544,1,FALSE
Sample2,1,-1,5231,5262,31,53420000,53730000,310000,0.19946368940345593,-0.30282976668144906,-0.502293456084905,1,TRUE
Sample2,1,1,5262,5307,45,53730000,54180000,450000,-0.30282976668144906,0.12111813121615632,0.4239478978976054,1,TRUE
Sample2,1,-1,5307,5327,20,54180000,54380000,200000,0.12111813121615632,-0.09029371241525361,-0.2114118436314099,1,TRUE
Sample2,1,1,5327,5371,44,54380000,54820000,440000,-0.09029371241525361,0.1477393581866861,0.2380330706019397,1,TRUE
Sample2,1,-1,5371,5386,15,54820000,54970000,150000,0.1477393581866861,0.10556797269294588,-0.04217138549374022,1,FALSE
Sample2,1,1,5386,5438,52,54970000,55490000,520000,0.10556797269294588,0.42485148194649475,0.31928350925354887,1,FALSE
Sample2,1,-1,5438,5535,97,55490000,56460000,970000,0.42485148194649475,-0.28008281339995056,-0.70493429534644525,1,TRUE
Sample2,1,1,5535,5574,39,56460000,56850000,390000,-0.28008281339995056,0.34107299125611545,0.621155804656066,1,TRUE
Sample2,1,-1,5574,5624,50,56850000,57350000,500000,0.34107299125611545,-0.09398407247643197,-0.43505706373254743,1,TRUE
Sample2,1,1,5624,5637,13,57350000,57480000,130000,-0.09398407247643197,-0.03427283866359047,0.0597112338128415,1,FALSE
Sample2,1,-1,5637,5724,87,57480000,58350000,870000,-0.03427283866359047,-0.47229187575755416,-0.43801903709396367,1,FALSE
Sample2,1,1,5724,5784,60,58350000,58950000,600000,-0.47229187575755416,0.24694339862748937,0.7192352743850435,1,TRUE
Sample2,1,-1,5784,5804,20,58950000,59150000,200000,0.24694339862748937,0.137070197866082,-0.10987320076140739,1,FALSE
Sample2,1,1,5804,5830,26,59150000,59410000,260000,0.137070197866082,0.366325585470976,0.229255387604894,1,FALSE
Sample2,1,-1,5830,5859,29,59410000,59700000,290000,0.366325585470976,-0.09764516658062687,-0.4639707520516029,1,TRUE
Sample2,1,1,5859,5891,32,59700000,60020000,320000,-0.09764516658062687,0.3205090967973162,0.4181542633779431,1,TRUE
Sample2,1,-1,5891,5974,83,60020000,60850000,830000,0.3205090967973162,-0.5017965088731792,-0.8223056056704954,1,TRUE
Sample2,1,1,5974,6011,37,60850000,61220000,370000,-0.5017965088731792,0.3515131325816128,0.853309641454792,1,TRUE
Sample2,1,-1,6011,6046,35,61220000,61570000,350000,0.3515131325816128,-0.3316325829203856,-0.6831457155019984,1,TRUE
Sample2,1,1,6046,6078,32,61570000,61890000,320000,-0.3316325829203856,0.35002359267767114,0.6816561755980568,1,TRUE
Sample2,1,-1,6078,6152,74,61890000,62630000,740000,0.35002359267767114,-0.18006433022844848,-0.5300879229061196,1,TRUE
Sample2,1,1,6152,6176,24,62630000,62870000,240000,-0.18006433022844848,0.3731322720309369,0.5531966022593854,1,TRUE
Sample2,1,-1,6176,6209,33,62870000,63200000,330000,0.3731322720309369,-0.3240195019700414,-0.6971517740009783,1,TRUE
Sample2,1,1,6209,6234,25,63200000,63450000,250000,-0.3240195019700414,0.19572577217606568,0.519745274146107,1,TRUE
Sample2,1,-1,6234,6303,69,63450000,64140000,690000,0.19572577217606568,-0.4689175161913577,-0.6646432883674234,1,TRUE
Sample2,1,1,6303,6339,36,64140000,64500000,360000,-0.4689175161913577,0.2780119080592139,0.7469294242505715,1,TRUE
Sample2,1,-1,6339,6378,39,64500000,64890000,390000,0.2780119080592139,-0.10727678413555129,-0.3852886921947652,1,TRUE
Sample2,1,1,6378,6411,33,64890000,65220000,330000,-0.10727678413555129,0.3625280099125826,0.4698047940481339,1,TRUE
Sample2,1,-1,6411,6500,89,65220000,66110000,890000,0.3625280099125826,-0.4228174265710196,-0.7853454364836022,1,TRUE
Sample2,1,1,6500,6570,70,66110000,66810000,700000,-0.4228174265710196,0.2290951155673335,0.6519125421383531,1,TRUE
Sample2,1,-1,6570,6630,60,66810000,67410000,600000,0.2290951155673335,-0.3183153379851399,-0.5474104535524734,1,TRUE
Sample2,1,1,6630,6677,47,67410000,67880000,470000,-0.3183153379851399,0.3580588875735911,0.6763742255587311,1,TRUE
Sample2,1,-1,6677,6708,31,67880000,68190000,310000,0.3580588875735911,-0.12398519299545219,-0.4820440805690433,1,TRUE
Sample2,1,1,6708,6760,52,68190000,68710000,520000,-0.12398519299545219,0.47754222053688583,0.6015274135323381,1,TRUE
Sample2,1,-1,6760,6863,103,68710000,69740000,1030000,0.47754222053688583,-0.34392045410886146,-0.8214626746457473,1,TRUE
Sample2,1,1,6863,6877,14,69740000,69880000,140000,-0.34392045410886146,-0.303274716941201,0.040645737167660456,1,FALSE
Sample2,1,-1,6877,6893,16,69880000,70040000,160000,-0.303274716941201,-0.34141433814625133,-0.03813962120505032,1,FALSE
Sample2,1,1,6893,6949,56,70040000,70600000,560000,-0.34141433814625133,0.4358807159412084,0.7772950540874597,1,TRUE
Sample2,1,-1,6949,6991,42,70600000,71020000,420000,0.4358807159412084,-0.05791166942955171,-0.49379238537076015,1,TRUE
Sample2,1,1,6991,7051,60,71020000,71620000,600000,-0.05791166942955171,0.3129656065546959,0.37087727598424763,1,TRUE
Sample2,1,-1,7051,7107,56,71620000,72180000,560000,0.3129656065546959,-0.35586172038257685,-0.6688273269372728,1,TRUE
Sample2,1,1,7107,7175,68,72180000,72860000,680000,-0.35586172038257685,0.20279514954818326,0.5586568699307601,1,TRUE
Sample2,1,-1,7175,7231,56,72860000,73420000,560000,0.20279514954818326,-0.058238813004405234,-0.2610339625525885,1,TRUE
Sample2,1,1,7231,7258,27,73420000,73690000,270000,-0.058238813004405234,0.09313645083317729,0.1513752638375825,1,TRUE
Sample2,1,-1,7258,7275,17,73690000,73860000,170000,0.09313645083317729,0.050887956422386076,-0.04224849441079121,1,FALSE
Sample2,1,1,7275,7286,11,73860000,73970000,110000,0.050887956422386076,0.06932950563605943,0.01844154921367335,1,FALSE
Sample2,1,-1,7286,7301,15,73970000,74120000,150000,0.06932950563605943,0.04985385772465843,-0.019475647911400995,1,FALSE
Sample2,1,1,7301,7312,11,74120000,74230000,110000,0.04985385772465843,0.06797932328028494,0.01812546555562651,1,FALSE
Sample2,1,-1,7312,7343,31,74230000,74540000,310000,0.06797932328028494,-0.11407586937509949,-0.18205519265538445,1,TRUE
Sample2,1,1,7343,7372,29,74540000,74830000,290000,-0.11407586937509949,0.11109682674753557,0.22517269612263507,1,TRUE
Sample2,1,-1,7372,7395,23,74830000,75060000,230000,0.11109682674753557,-0.11410272895825378,-0.22519955570578937,1,TRUE
Sample2,1,1,7395,7413,18,75060000,75240000,180000,-0.11410272895825378,-0.039971458479468217,0.07413127047878557,1,FALSE
Sample2,1,-1,7413,7451,38,75240000,75620000,380000,-0.039971458479468217,-0.39060345124433066,-0.35063199276486245,1,FALSE
Sample2,1,1,7451,7488,37,75620000,75990000,370000,-0.39060345124433066,0.4150722757700623,0.8056757270143929,1,TRUE
Sample2,1,-1,7488,7612,124,75990000,77230000,1240000,0.4150722757700623,-0.38796494896222067,-0.803037224732283,1,TRUE
Sample2,1,1,7612,7635,23,77230000,77460000,230000,-0.38796494896222067,-0.34060044462337763,0.04736450433884304,1,FALSE
Sample2,1,-1,7635,7649,14,77460000,77600000,140000,-0.34060044462337763,-0.38000975874149495,-0.03940931411811732,1,FALSE
Sample2,1,1,7649,7705,56,77600000,78160000,560000,-0.38000975874149495,0.4028823346846595,0.7828920934261545,1,TRUE
Sample2,1,-1,7705,7753,48,78160000,78640000,480000,0.4028823346846595,0.17084564700974894,-0.23203668767491056,1,FALSE
Sample2,1,1,7753,7763,10,78640000,78740000,100000,0.17084564700974894,0.18975051401645676,0.01890486700670782,1,FALSE
Sample2,1,-1,7763,7797,34,78740000,79080000,340000,0.18975051401645676,-0.01843393259852831,-0.20818444661498509,1,TRUE
Sample2,1,1,7797,7841,44,79080000,79520000,440000,-0.01843393259852831,0.20017861446656618,0.21861254706509448,1,TRUE
Sample2,1,-1,7841,7878,37,79520000,79890000,370000,0.20017861446656618,-0.06926479165283653,-0.2694434061194027,1,TRUE
Sample2,1,1,7878,7901,23,79890000,80120000,230000,-0.06926479165283653,0.06307612139179082,0.13234091304462736,1,TRUE
Sample2,1,-1,7901,7920,19,80120000,80310000,190000,0.06307612139179082,-0.07201712955948175,-0.13509325095127256,1,TRUE
Sample2,1,1,7920,7941,21,80310000,80520000,210000,-0.07201712955948175,-0.016644682599758015,0.05537244695972374,1,FALSE
Sample2,1,-1,7941,7995,54,80520000,81060000,540000,-0.016644682599758015,-0.25240846339986706,-0.23576378080010904,1,FALSE
Sample2,1,1,7995,8005,10,81060000,81160000,100000,-0.25240846339986706,-0.24215651520819764,0.010251948191669413,1,FALSE
Sample2,1,-1,8005,8027,22,81160000,81380000,220000,-0.24215651520819764,-0.27151948043423024,-0.0293629652260326,1,FALSE
Sample2,1,1,8027,8074,47,81380000,81850000,470000,-0.27151948043423024,0.20451654469285135,0.4760360251270816,1,TRUE
Sample2,1,-1,8074,8096,22,81850000,82070000,220000,0.20451654469285135,0.04150972974959278,-0.16300681494325858,1,FALSE
Sample2,1,1,8096,8109,13,82070000,82200000,130000,0.04150972974959278,0.08739371071119445,0.04588398096160167,1,FALSE
Sample2,1,-1,8109,8134,25,82200000,82450000,250000,0.08739371071119445,-0.17962222875509173,-0.2670159394662862,1,TRUE
Sample2,1,1,8134,8166,32,82450000,82770000,320000,-0.17962222875509173,0.14951490665053163,0.3291371354056234,1,TRUE
Sample2,1,-1,8166,8215,49,82770000,83470000,700000,0.14951490665053163,-0.3998656678879999,-0.5493805745385315,0.7,TRUE
Sample2,1,1,8215,8234,19,83470000,83660000,190000,-0.3998656678879999,-0.3580644513287869,0.041801216559212984,1,FALSE
Sample2,1,-1,8234,8255,21,83660000,83870000,210000,-0.3580644513287869,-0.43472073247208515,-0.07665628114329825,1,FALSE
Sample2,1,1,8255,8323,68,83870000,84550000,680000,-0.43472073247208515,0.16261198242647493,0.5973327148985601,1,TRUE
Sample2,1,-1,8323,8374,51,84550000,85060000,510000,0.16261198242647493,-0.27675186224918635,-0.43936384467566125,1,TRUE
Sample2,1,1,8374,8466,92,85060000,85980000,920000,-0.27675186224918635,0.29540524451267014,0.5721571067618565,1,TRUE
Sample2,1,-1,8466,8535,69,85980000,86670000,690000,0.29540524451267014,-0.3314828134622767,-0.6268880579749468,1,TRUE
Sample2,1,1,8535,8565,30,86670000,86970000,300000,-0.3314828134622767,0.37642629890022533,0.7079091123625021,1,TRUE
Sample2,1,-1,8565,8649,84,86970000,87810000,840000,0.37642629890022533,-0.06007878973099839,-0.4365050886312237,1,TRUE
Sample2,1,1,8649,8674,25,87810000,88060000,250000,-0.06007878973099839,0.06602733161768347,0.12610612134868185,1,TRUE
Sample2,1,-1,8674,8719,45,88060000,88510000,450000,0.06602733161768347,-0.4057722014761419,-0.4717995330938254,1,TRUE
Sample2,1,1,8719,8772,53,88510000,89040000,530000,-0.4057722014761419,0.31122688992046177,0.7169990913966037,1,TRUE
Sample2,1,-1,8772,8811,39,89040000,89430000,390000,0.31122688992046177,-0.22358216721350005,-0.5348090571339619,1,TRUE
Sample2,1,1,8811,8821,10,89430000,89530000,100000,-0.22358216721350005,-0.18967855224126234,0.033903614972237706,1,FALSE
Sample2,1,-1,8821,8832,11,89530000,89640000,110000,-0.18967855224126234,-0.23031945679748156,-0.040640904556219215,1,FALSE
Sample2,1,1,8832,8885,53,89640000,90170000,530000,-0.23031945679748156,0.46773596416848495,0.6980554209659665,1,TRUE
Sample2,1,-1,8885,8932,47,90170000,90640000,470000,0.46773596416848495,-0.24809828167028997,-0.715834245838775,1,TRUE
Sample2,1,1,8932,8950,18,90640000,90820000,180000,-0.24809828167028997,-0.08944240754285497,0.15865587412743498,1,FALSE
Sample2,1,-1,8950,8964,14,90820000,90960000,140000,-0.08944240754285497,-0.16581645495110736,-0.07637404740825239,1,FALSE
Sample2,1,1,8964,8983,19,90960000,91150000,190000,-0.16581645495110736,0.060895316991953004,0.22671177194306036,1,TRUE
Sample2,1,-1,8983,9006,23,91150000,91380000,230000,0.060895316991953004,-0.2868383734058667,-0.3477336903978197,1,TRUE
Sample2,1,1,9006,9029,23,91380000,91610000,230000,-0.2868383734058667,-0.008570226560937769,0.27826814684492895,1,FALSE
Sample2,1,-1,9029,9053,24,91610000,91850000,240000,-0.008570226560937769,-0.3000510279535079,-0.29148080139257015,1,FALSE
Sample2,1,1,9053,9079,26,91850000,92110000,260000,-0.3000510279535079,-0.038025393929767094,0.2620256340237408,1,FALSE
Sample2,1,-1,9079,9102,23,92110000,92340000,230000,-0.038025393929767094,-0.17673190884434345,-0.13870651491457636,1,FALSE
Sample2,1,1,9102,9120,18,92340000,92520000,180000,-0.17673190884434345,0.032023374052252786,0.20875528289659623,1,TRUE
Sample2,1,-1,9120,9138,18,92520000,92700000,180000,0.032023374052252786,-0.2628483020314462,-0.294871676083699,1,TRUE
Sample2,1,1,9138,9175,37,92700000,93070000,370000,-0.2628483020314462,0.1792913401896646,0.4421396422211108,1,TRUE
Sample2,1,-1,9175,9197,22,93070000,93290000,220000,0.1792913401896646,-0.042418488215435285,-0.2217098284050999,1,TRUE
Sample2,1,1,9197,9213,16,93290000,93450000,160000,-0.042418488215435285,0.06362999190644052,0.1060484801218758,1,TRUE
Sample2,1,-1,9213,9234,21,93450000,93660000,210000,0.06362999190644052,-0.14359450112792857,-0.20722449303436907,1,TRUE
Sample2,1,1,9234,9267,33,93660000,93990000,330000,-0.14359450112792857,0.36976601205139586,0.5133605131793244,1,TRUE
Sample2,1,-1,9267,9300,33,93990000,94320000,330000,0.36976601205139586,0.017187301462552936,-0.35257871058884294,1,FALSE
Sample2,1,1,9300,9319,19,94320000,94510000,190000,0.017187301462552936,0.06731713486480356,0.05012983340225063,1,FALSE
Sample2,1,-1,9319,9347,28,94510000,94790000,280000,0.06731713486480356,-0.17447456636856334,-0.2417917012333669,1,TRUE
Sample2,1,1,9347,9403,56,94790000,95350000,560000,-0.17447456636856334,0.39799117063829176,0.5724657370068551,1,TRUE
Sample2,1,-1,9403,9491,88,95350000,96230000,880000,0.39799117063829176,-0.24933580743293568,-0.6473269780712274,1,TRUE
Sample2,1,1,9491,9545,54,96230000,96770000,540000,-0.24933580743293568,0.09287687676471099,0.34221268419764667,1,TRUE
Sample2,1,-1,9545,9564,19,96770000,96960000,190000,0.09287687676471099,-0.06998352922792427,-0.16286040599263524,1,TRUE
Sample2,1,1,9564,9593,29,96960000,97250000,290000,-0.06998352922792427,0.326608875433617,0.3965924046615413,1,TRUE
Sample2,1,-1,9593,9651,58,97250000,97830000,580000,0.326608875433617,-0.28243538372063964,-0.6090442591542566,1,TRUE
Sample2,1,1,9651,9681,30,97830000,98130000,300000,-0.28243538372063964,0.03270195069267684,0.3151373344133165,1,TRUE
Sample2,1,-1,9681,9695,14,98130000,98270000,140000,0.03270195069267684,-0.04932392772467198,-0.08202587841734882,1,TRUE
Sample2,1,1,9695,9723,28,98270000,98550000,280000,-0.04932392772467198,0.3017694617630617,0.35109338948773366,1,TRUE
Sample2,1,-1,9723,9814,91,98550000,99460000,910000,0.3017694617630617,-0.4701973043658338,-0.7719667661288955,1,TRUE
Sample2,1,1,9814,9862,48,99460000,99940000,480000,-0.4701973043658338,-0.09321365337866963,0.37698365098716413,1,FALSE
Sample2,1,-1,9862,9882,20,99940000,100140000,200000,-0.09321365337866963,-0.24093092329520838,-0.14771726991653875,1,FALSE
Sample2,1,1,9882,9911,29,100140000,100430000,290000,-0.24093092329520838,0.32065377407078843,0.5615846973659968,1,TRUE
Sample2,1,-1,9911,9964,53,100430000,100960000,530000,0.32065377407078843,-0.19102400357068067,-0.5116777776414692,1,TRUE
Sample2,1,1,9964,10007,43,100960000,101390000,430000,-0.19102400357068067,0.42215764728436544,0.6131816508550461,1,TRUE
Sample2,1,-1,10007,10023,16,101390000,101550000,160000,0.42215764728436544,0.349759169529402,-0.07239847775496344,1,FALSE
Sample2,1,1,10023,10037,14,101550000,101690000,140000,0.349759169529402,0.37639747879096513,0.02663830926156313,1,FALSE
Sample2,1,-1,10037,10103,66,101690000,102350000,660000,0.37639747879096513,-0.22068610167478164,-0.5970835804657468,1,TRUE
Sample2,1,1,10103,10121,18,102350000,102530000,180000,-0.22068610167478164,-0.12479161023940662,0.09589449143537503,1,FALSE
Sample2,1,-1,10121,10144,23,102530000,102760000,230000,-0.12479161023940662,-0.2616128779766499,-0.1368212677372433,1,FALSE
Sample2,1,1,10144,10179,35,102760000,103110000,350000,-0.2616128779766499,0.17881505726922545,0.4404279352458753,1,TRUE
Sample2,1,-1,10179,10211,32,103110000,103430000,320000,0.17881505726922545,0.013072438258620412,-0.16574261901060502,1,FALSE
Sample2,1,1,10211,10229,18,103430000,103610000,180000,0.013072438258620412,0.0859188217211488,0.07284638346252839,1,FALSE
Sample2,1,-1,10229,10244,15,103610000,103850000,240000,0.0859188217211488,0.01891457333842924,-0.06700424838271957,0.625,FALSE
Sample2,1,1,10244,10263,19,103850000,104040000,190000,0.01891457333842924,0.061399067881816205,0.042484494543386965,1,FALSE
Sample2,1,-1,10263,10312,49,104040000,104530000,490000,0.061399067881816205,-0.15687746741970052,-0.21827653530151672,1,TRUE
Sample2,1,1,10312,10383,71,104530000,105240000,710000,-0.15687746741970052,0.11771011092393893,0.27458757834363945,1,TRUE
Sample2,1,-1,10383,10425,42,105240000,105660000,420000,0.11771011092393893,0.021026158553383096,-0.09668395237055584,1,FALSE
Sample2,1,1,10425,10447,22,105660000,105880000,220000,0.021026158553383096,0.11151471548472905,0.09048855693134596,1,FALSE
Sample2,1,-1,10447,10489,42,105880000,106300000,420000,0.11151471548472905,-0.025102739234815846,-0.1366174547195449,1,TRUE
Sample2,1,1,10489,10511,22,106300000,106520000,220000,-0.025102739234815846,0.01482848514965235,0.039931224384468195,1,TRUE
Sample2,1,-1,10511,10554,43,106520000,106950000,430000,0.01482848514965235,-0.12477752742595802,-0.13960601257561037,1,TRUE
Sample2,1,1,10554,10571,17,106950000,107120000,170000,-0.12477752742595802,-0.07015221670498688,0.05462531072097114,1,FALSE
Sample2,1,-1,10571,10636,65,107120000,107770000,650000,-0.07015221670498688,-0.42442632581850076,-0.35427410911351387,1,FALSE
Sample2,1,1,10636,10663,27,107770000,108040000,270000,-0.42442632581850076,-0.2816419984732448,0.14278432734525598,1,FALSE
Sample2,1,-1,10663,10693,30,108040000,108400000,360000,-0.2816419984732448,-0.4559809519661461,-0.1743389534929013,0.8333333333333334,FALSE
Sample2,1,1,10693,10779,86,108400000,109260000,860000,-0.4559809519661461,0.13293847266200717,0.5889194246281533,1,TRUE
Sample2,1,-1,10779,10796,17,109260000,109430000,170000,0.13293847266200717,0.04649150062304683,-0.08644697203896035,1,FALSE
Sample2,1,1,10796,10821,25,109430000,109680000,250000,0.04649150062304683,0.29789333092833675,0.25140183030528995,1,FALSE
Sample2,1,-1,10821,10850,29,109680000,109970000,290000,0.29789333092833675,-0.2044519451808841,-0.5023452761092209,1,TRUE
Sample2,1,1,10850,10914,64,109970000,110610000,640000,-0.2044519451808841,0.44865551499661027,0.6531074601774944,1,TRUE
Sample2,1,-1,10914,10993,79,110610000,111400000,790000,0.44865551499661027,-0.32923801462057156,-0.7778935296171818,1,TRUE
Sample2,1,1,10993,11038,45,111400000,111850000,450000,-0.32923801462057156,0.267532532004058,0.5967705466246296,1,TRUE
Sample2,1,-1,11038,11080,42,111850000,112270000,420000,0.267532532004058,-0.4340592645483991,-0.7015917965524572,1,TRUE
Sample2,1,1,11080,11113,33,112270000,112600000,330000,-0.4340592645483991,-0.023733124901122032,0.41032613964727704,1,FALSE
Sample2,1,-1,11113,11128,15,112600000,112750000,150000,-0.023733124901122032,-0.08478841055522808,-0.06105528565410605,1,FALSE
Sample2,1,1,11128,11172,44,112750000,113190000,440000,-0.08478841055522808,0.3581828561202813,0.44297126667550935,1,TRUE
Sample2,1,-1,11172,11221,49,113190000,113680000,490000,0.3581828561202813,-0.44275266299019495,-0.8009355191104762,1,TRUE
Sample2,1,1,11221,11259,38,113680000,114060000,380000,-0.44275266299019495,0.2430500784145731,0.685802741404768,1,TRUE
Sample2,1,-1,11259,11295,36,114060000,114420000,360000,0.2430500784145731,-0.18354544140391366,-0.42659551981848676,1,TRUE
Sample2,1,1,11295,11337,42,114420000,114840000,420000,-0.18354544140391366,0.25710043915403447,0.4406458805579481,1,TRUE
Sample2,1,-1,11337,11360,23,114840000,115070000,230000,0.25710043915403447,0.058344882844005665,-0.1987555563100288,1,FALSE
Sample2,1,1,11360,11380,20,115070000,115270000,200000,0.058344882844005665,0.18056912920143964,0.12222424635743398,1,FALSE
Sample2,1,-1,11380,11402,22,115270000,115490000,220000,0.18056912920143964,-0.00671170628625551,-0.18728083548769514,1,TRUE
Sample2,1,1,11402,11430,28,115490000,115770000,280000,-0.00671170628625551,0.24075693625984612,0.24746864254610162,1,TRUE
Sample2,1,-1,11430,11483,53,115770000,116300000,530000,0.24075693625984612,-0.13883553103666454,-0.37959246729651064,1,TRUE
Sample2,1,1,11483,11531,48,116300000,116780000,480000,-0.13883553103666454,0.17505917425306633,0.31389470528973085,1,TRUE
Sample2,1,-1,11531,11574,43,116780000,117210000,430000,0.17505917425306633,-0.09429740634647556,-0.2693565805995419,1,TRUE
Sample2,1,1,11574,11597,23,117210000,117440000,230000,-0.09429740634647556,0.08840269460501088,0.18270010095148642,1,TRUE
Sample2,1,-1,11597,11622,25,117440000,117690000,250000,0.08840269460501088,-0.11652961594476405,-0.20493231054977493,1,TRUE
Sample2,1,1,11622,11661,39,117690000,118080000,390000,-0.11652961594476405,0.31427627954443943,0.43080589548920345,1,TRUE
Sample2,1,-1,11661,11739,78,118080000,118860000,780000,0.31427627954443943,-0.20479716567290734,-0.5190734452173468,1,TRUE
Sample2,1,1,11739,11756,17,118860000,119030000,170000,-0.20479716567290734,-0.11646778130117094,0.0883293843717364,1,FALSE
Sample2,1,-1,11756,11802,46,119030000,119490000,460000,-0.11646778130117094,-0.43331377791562953,-0.31684599661445856,1,FALSE
Sample2,1,1,11802,11827,25,119490000,119740000,250000,-0.43331377791562953,-0.08189726923159227,0.3514165086840373,1,FALSE
Sample2,1,-1,11827,11851,24,119740000,119980000,240000,-0.08189726923159227,-0.18324165973883944,-0.10134439050724717,1,FALSE
Sample2,1,1,11851,11881,30,119980000,121590000,1610000,-0.18324165973883944,0.1935952707906998,0.37683693052953926,0.18633540372670807,TRUE
Sample2,1,-1,11881,11970,89,121590000,145780000,24190000,0.1935952707906998,-0.1180932623740097,-0.3116885331647095,0.03679206283588259,TRUE
Sample2,1,1,11970,12032,62,145780000,147250000,1470000,-0.1180932623740097,0.1016413807525957,0.2197346431266054,0.4217687074829932,TRUE
Sample2,1,-1,12032,12052,20,147250000,147450000,200000,0.1016413807525957,-0.11678353394616767,-0.21842491469876335,1,TRUE
Sample2,1,1,12052,12069,17,147450000,147620000,170000,-0.11678353394616767,0.030778933518750173,0.14756246746491783,1,TRUE
Sample2,1,-1,12069,12107,38,147620000,148000000,380000,0.030778933518750173,-0.37943097561026745,-0.4102099091290176,1,TRUE
Sample2,1,1,12107,12136,29,148000000,148470000,470000,-0.37943097561026745,0.0030417682306757635,0.3824727438409432,0.6170212765957447,TRUE
Sample2,1,-1,12136,12169,33,148470000,150120000,1650000,0.0030417682306757635,-0.2810880649990519,-0.2841298332297277,0.2,TRUE
Sample2,1,1,12169,12195,26,150120000,150380000,260000,-0.2810880649990519,0.0018940841592531637,0.2829821491583051,1,TRUE
Sample2,1,-1,12195,12207,12,150380000,150500000,120000,0.0018940841592531637,-0.09918131869371413,-0.1010754028529673,1,TRUE
Sample2,1,1,12207,12225,18,150500000,150680000,180000,-0.09918131869371413,0.02502195352894869,0.12420327222266282,1,TRUE
Sample2,1,-1,12225,12249,24,150680000,150920000,240000,0.02502195352894869,-0.11626430403000904,-0.14128625755895774,1,TRUE
Sample2,1,1,12249,12312,63,150920000,151550000,630000,-0.11626430403000904,0.1539347693539911,0.2701990733840002,1,TRUE
Sample2,1,-1,12312,12344,32,151550000,151870000,320000,0.1539347693539911,-0.19055690300639722,-0.34449167236038836,1,TRUE
Sample2,1,1,12344,12379,35,151870000,152220000,350000,-0.19055690300639722,0.4794660121760586,0.6700229151824558,1,TRUE
Sample2,1,-1,12379,12477,98,152220000,153200000,980000,0.4794660121760586,-0.49081762572983895,-0.9702836379058976,1,TRUE
Sample2,1,1,12477,12534,57,153200000,153770000,570000,-0.49081762572983895,0.0974061371517804,0.5882237628816194,1,TRUE
Sample2,1,-1,12534,12567,33,153770000,154100000,330000,0.0974061371517804,0.010239729478321562,-0.08716640767345883,1,FALSE
Sample2,1,1,12567,12591,24,154100000,154340000,240000,0.010239729478321562,0.16077234657314188,0.15053261709482033,1,FALSE
Sample2,1,-1,12591,12644,53,154340000,154870000,530000,0.16077234657314188,-0.35424123290663345,-0.5150135794797753,1,TRUE
Sample2,1,1,12644,12689,45,154870000,155320000,450000,-0.35424123290663345,0.18585720054539567,0.5400984334520291,1,TRUE
Sample2,1,-1,12689,12712,23,155320000,155550000,230000,0.18585720054539567,-0.19603432630908937,-0.381891526854485,1,TRUE
Sample2,1,1,12712,12728,16,155550000,155710000,160000,-0.19603432630908937,-0.07702442855321456,0.11900989775587481,1,FALSE
Sample2,1,-1,12728,12744,16,155710000,155870000,160000,-0.07702442855321456,-0.22244377331545234,-0.14541934476223778,1,FALSE
Sample2,1,1,12744,12771,27,155870000,156140000,270000,-0.22244377331545234,0.0990418069410937,0.32148558025654606,1,TRUE
Sample2,1,-1,12771,12807,36,156140000,156500000,360000,0.0990418069410937,-0.11709266991114707,-0.21613447685224077,1,TRUE
Sample2,1,1,12807,12889,82,156500000,157320000,820000,-0.11709266991114707,0.5084721230943412,0.6255647930054883,1,TRUE
Sample2,1,-1,12889,12945,56,157320000,157880000,560000,0.5084721230943412,-0.37835249202595284,-0.8868246151202941,1,TRUE
Sample2,1,1,12945,12987,42,157880000,158300000,420000,-0.37835249202595284,0.44405962019995954,0.8224121122259124,1,TRUE
Sample2,1,-1,12987,13060,73,158300000,159030000,730000,0.44405962019995954,-0.2878308418799114,-0.731890462079871,1,TRUE
Sample2,1,1,13060,13080,20,159030000,159230000,200000,-0.2878308418799114,-0.13556415245769965,0.15226668942221178,1,FALSE
Sample2,1,-1,13080,13123,43,159230000,159660000,430000,-0.13556415245769965,-0.47307697675588434,-0.3375128242981847,1,FALSE
Sample2,1,1,13123,13202,79,159660000,160450000,790000,-0.47307697675588434,0.41281875541461843,0.8858957321705028,1,TRUE
Sample2,1,-1,13202,13248,46,160450000,160910000,460000,0.41281875541461843,-0.5003180430035732,-0.9131367984181916,1,TRUE
Sample2,1,1,13248,13314,66,160910000,161570000,660000,-0.5003180430035732,0.24683390593045076,0.7471519489340239,1,TRUE
Sample2,1,-1,13314,13353,39,161570000,161960000,390000,0.24683390593045076,0.08885519562488965,-0.1579787103055611,1,FALSE
Sample2,1,1,13353,13371,18,161960000,162140000,180000,0.08885519562488965,0.33362405494773084,0.2447688593228412,1,FALSE
Sample2,1,-1,13371,13399,28,162140000,162420000,280000,0.33362405494773084,-0.3014619898103773,-0.6350860447581081,1,TRUE
Sample2,1,1,13399,13447,48,162420000,162900000,480000,-0.3014619898103773,0.329968705726593,0.6314306955369703,1,TRUE
Sample2,1,-1,13447,13463,16,162900000,163060000,160000,0.329968705726593,0.24508877744143984,-0.08487992828515314,1,FALSE
Sample2,1,1,13463,13501,38,163060000,163440000,380000,0.24508877744143984,0.3052585999208816,0.060169822479441776,1,FALSE
Sample2,1,-1,13501,13583,82,163440000,164260000,820000,0.3052585999208816,-0.2705662378810671,-0.5758248378019487,1,TRUE
Sample2,1,1,13583,13624,41,164260000,164670000,410000,-0.2705662378810671,0.04458843577226698,0.31515467365333405,1,TRUE
Sample2,1,-1,13624,13692,68,164670000,165350000,680000,0.04458843577226698,-0.448852755224852,-0.49344119099711903,1,TRUE
Sample2,1,1,13692,13753,61,165350000,165960000,610000,-0.448852755224852,0.4644075372432583,0.9132602924681104,1,TRUE
Sample2,1,-1,13753,13772,19,165960000,166150000,190000,0.4644075372432583,0.34854656049632143,-0.11586097674693685,1,FALSE
Sample2,1,1,13772,13784,12,166150000,166270000,120000,0.34854656049632143,0.37040614706324926,0.021859586566927824,1,FALSE
Sample2,1,-1,13784,13834,50,166270000,166770000,500000,0.37040614706324926,-0.21448951261178928,-0.5848956596750385,1,TRUE
Sample2,1,1,13834,13848,14,166770000,166910000,140000,-0.21448951261178928,-0.1532156784386886,0.06127383417310067,1,FALSE
Sample2,1,-1,13848,13868,20,166910000,167110000,200000,-0.1532156784386886,-0.29185686516003295,-0.13864118672134434,1,FALSE
Sample2,1,1,13868,13881,13,167110000,167240000,130000,-0.29185686516003295,-0.21256966275256273,0.07928720240747023,1,FALSE
Sample2,1,-1,13881,13896,15,167240000,167390000,150000,-0.21256966275256273,-0.2860368739555028,-0.07346721120294009,1,FALSE
Sample2,1,1,13896,13950,54,167390000,167930000,540000,-0.2860368739555028,0.16555673101190774,0.4515936049674105,1,TRUE
Sample2,1,-1,13950,13967,17,167930000,168100000,170000,0.16555673101190774,0.015453818127989113,-0.15010291288391864,1,FALSE
Sample2,1,1,13967,14013,46,168100000,168560000,460000,0.015453818127989113,0.4959562234566235,0.48050240532863436,1,FALSE
Sample2,1,-1,14013,14053,40,168560000,168960000,400000,0.4959562234566235,-0.1992525736170439,-0.6952087970736673,1,TRUE
Sample2,1,1,14053,14074,21,168960000,169170000,210000,-0.1992525736170439,0.123417743484477,0.3226703171015209,1,TRUE
Sample2,1,-1,14074,14093,19,169170000,169360000,190000,0.123417743484477,-0.25024389258569335,-0.37366163607017033,1,TRUE
Sample2,1,1,14093,14114,21,169360000,169570000,210000,-0.25024389258569335,0.1343144456144999,0.38455833820019325,1,TRUE
Sample2,1,-1,14114,14134,20,169570000,169770000,200000,0.1343144456144999,-0.13599104979397691,-0.2703054954084768,1,TRUE
Sample2,1,1,14134,14176,42,169770000,170190000,420000,-0.13599104979397691,0.2249460784208612,0.36093712821483814,1,TRUE
Sample2,1,-1,14176,14202,26,170190000,170450000,260000,0.2249460784208612,-0.04811692823183392,-0.2730630066526951,1,TRUE
Sample2,1,1,14202,14224,22,170450000,170670000,220000,-0.04811692823183392,0.08744325421809629,0.1355601824499302,1,TRUE
Sample2,1,-1,14224,14282,58,170670000,171250000,580000,0.08744325421809629,-0.5005229934521033,-0.5879662476701996,1,TRUE
Sample2,1,1,14282,14342,60,171250000,171850000,600000,-0.5005229934521033,0.21326879401883353,0.7137917874709367,1,TRUE
Sample2,1,-1,14342,14377,35,171850000,172200000,350000,0.21326879401883353,-0.10575984304929394,-0.31902863706812745,1,TRUE
Sample2,1,1,14377,14416,39,172200000,172590000,390000,-0.10575984304929394,0.12998358918981248,0.23574343223910643,1,TRUE
Sample2,1,-1,14416,14439,23,172590000,172820000,230000,0.12998358918981248,0.012941432538313542,-0.11704215665149895,1,FALSE
Sample2,1,1,14439,14455,16,172820000,172980000,160000,0.012941432538313542,0.08507323226823915,0.07213179972992562,1,FALSE
Sample2,1,-1,14455,14492,37,172980000,173350000,370000,0.08507323226823915,-0.37003205819883844,-0.4551052904670776,1,TRUE
Sample2,1,1,14492,14522,30,173350000,173650000,300000,-0.37003205819883844,-0.10152081900939038,0.2685112391894481,1,FALSE
Sample2,1,-1,14522,14541,19,173650000,173840000,190000,-0.10152081900939038,-0.21194844880455477,-0.11042762979516439,1,FALSE
Sample2,1,1,14541,14592,51,173840000,174350000,510000,-0.21194844880455477,0.5100112688824009,0.7219597176869557,1,TRUE
Sample2,1,-1,14592,14651,59,174350000,174940000,590000,0.5100112688824009,-0.2327805026473156,-0.7427917715297165,1,TRUE
Sample2,1,1,14651,14684,33,174940000,175270000,330000,-0.2327805026473156,0.24883105636428135,0.4816115590115969,1,TRUE
Sample2,1,-1,14684,14730,46,175270000,175730000,460000,0.24883105636428135,-0.22642695987142938,-0.47525801623571073,1,TRUE
Sample2,1,1,14730,14751,21,175730000,175940000,210000,-0.22642695987142938,-0.024435808992102466,0.20199115087932693,1,FALSE
Sample2,1,-1,14751,14770,19,175940000,176130000,190000,-0.024435808992102466,-0.28224030211223916,-0.2578044931201367,1,FALSE
Sample2,1,1,14770,14801,31,176130000,176440000,310000,-0.28224030211223916,0.40203108387178227,0.6842713859840215,1,TRUE
Sample2,1,-1,14801,14926,125,176440000,177690000,1250000,0.40203108387178227,-0.5807103903487997,-0.982741474220582,1,TRUE
Sample2,1,1,14926,14977,51,177690000,178200000,510000,-0.5807103903487997,0.2826488128557637,0.8633592032045634,1,TRUE
Sample2,1,-1,14977,14998,21,178200000,178410000,210000,0.2826488128557637,-0.14014817856952022,-0.42279699142528393,1,TRUE
Sample2,1,1,14998,15021,23,178410000,178640000,230000,-0.14014817856952022,0.29485770195405864,0.43500588052357886,1,TRUE
Sample2,1,-1,15021,15052,31,178640000,178950000,310000,0.29485770195405864,-0.24857468548626818,-0.5434323874403268,1,TRUE
Sample2,1,1,15052,15097,45,178950000,179400000,450000,-0.24857468548626818,0.3625065861516491,0.6110812716379173,1,TRUE
Sample2,1,-1,15097,15132,35,179400000,179750000,350000,0.3625065861516491,-0.28858793834180724,-0.6510945244934563,1,TRUE
Sample2,1,1,15132,15158,26,179750000,180010000,260000,-0.28858793834180724,-0.01688270239337167,0.27170523594843554,1,FALSE
Sample2,1,-1,15158,15169,11,180010000,180120000,110000,-0.01688270239337167,-0.0823616603911557,-0.06547895799778403,1,FALSE
Sample2,1,1,15169,15192,23,180120000,180350000,230000,-0.0823616603911557,0.1825371191289674,0.2648987795201231,1,TRUE
Sample2,1,-1,15192,15207,15,180350000,180500000,150000,0.1825371191289674,0.09055742471787462,-0.09197969441109277,1,FALSE
Sample2,1,1,15207,15221,14,180500000,180640000,140000,0.09055742471787462,0.1793959147283081,0.08883849001043348,1,FALSE
Sample2,1,-1,15221,15249,28,180640000,180920000,280000,0.1793959147283081,-0.3255098738854497,-0.5049057886137578,1,TRUE
Sample2,1,1,15249,15288,39,180920000,181310000,390000,-0.3255098738854497,0.5358903965457605,0.8614002704312103,1,TRUE
Sample2,1,-1,15288,15298,10,181310000,181410000,100000,0.5358903965457605,0.5100285315088134,-0.025861865036947096,1,FALSE
Sample2,1,1,15298,15309,11,181410000,181520000,110000,0.5100285315088134,0.5326448413604722,0.022616309851658745,1,FALSE
Sample2,1,-1,15309,15431,122,181520000,182740000,1220000,0.5326448413604722,-0.4207135390764257,-0.9533583804368979,1,TRUE
Sample2,1,1,15431,15489,58,182740000,183320000,580000,-0.4207135390764257,0.2685699377751126,0.6892834768515383,1,TRUE
Sample2,1,-1,15489,15506,17,183320000,183490000,170000,0.2685699377751126,0.1417668796779507,-0.1268030580971619,1,FALSE
Sample2,1,1,15506,15530,24,183490000,183730000,240000,0.1417668796779507,0.4722546288196696,0.3304877491417189,1,FALSE
Sample2,1,-1,15530,15554,24,183730000,183970000,240000,0.4722546288196696,0.17747584397416663,-0.294778784845503,1,FALSE
Sample2,1,1,15554,15573,19,183970000,184160000,190000,0.17747584397416663,0.28843444258311124,0.11095859860894461,1,FALSE
Sample2,1,-1,15573,15618,45,184160000,184610000,450000,0.28843444258311124,-0.3131391353242249,-0.6015735779073361,1,TRUE
Sample2,1,1,15618,15671,53,184610000,185140000,530000,-0.3131391353242249,0.23587211385933002,0.5490112491835549,1,TRUE
Sample2,1,-1,15671,15713,42,185140000,185560000,420000,0.23587211385933002,-0.036040336074998285,-0.2719124499343283,1,TRUE
Sample2,1,1,15713,15735,22,185560000,185780000,220000,-0.036040336074998285,0.17748754179702725,0.21352787787202554,1,TRUE
Sample2,1,-1,15735,15766,31,185780000,186090000,310000,0.17748754179702725,-0.28150203832166687,-0.4589895801186941,1,TRUE
Sample2,1,1,15766,15814,48,186090000,186570000,480000,-0.28150203832166687,0.22626287104485288,0.5077649093665197,1,TRUE
Sample2,1,-1,15814,15835,21,186570000,186780000,210000,0.22626287104485288,0.18542288192051157,-0.04083998912434131,1,FALSE
Sample2,1,1,15835,15862,27,186780000,187050000,270000,0.18542288192051157,0.3052500875842889,0.11982720566377733,1,FALSE
Sample2,1,-1,15862,15940,78,187050000,187830000,780000,0.3052500875842889,-0.20491347043055974,-0.5101635580148487,1,TRUE
Sample2,1,1,15940,15959,19,187830000,188020000,190000,-0.20491347043055974,-0.16296103633103018,0.04195243409952956,1,FALSE
Sample2,1,-1,15959,15973,14,188020000,188160000,140000,-0.16296103633103018,-0.19552192085186318,-0.032560884520833,1,FALSE
Sample2,1,1,15973,16051,78,188160000,188940000,780000,-0.19552192085186318,0.02657370996170995,0.22209563081357314,1,TRUE
Sample2,1,-1,16051,16097,46,188940000,189400000,460000,0.02657370996170995,-0.2308572439317762,-0.25743095389348614,1,TRUE
Sample2,1,1,16097,16137,40,189400000,189800000,400000,-0.2308572439317762,0.13670677200003825,0.3675640159318144,1,TRUE
Sample2,1,-1,16137,16153,16,189800000,189960000,160000,0.13670677200003825,0.06193757164756217,-0.07476920035247608,1,FALSE
Sample2,1,1,16153,16168,15,189960000,190110000,150000,0.06193757164756217,0.1320551535616396,0.07011758191407744,1,FALSE
Sample2,1,-1,16168,16194,26,190110000,190370000,260000,0.1320551535616396,-0.23146871898685178,-0.3635238725484914,1,TRUE
Sample2,1,1,16194,16243,49,190370000,190860000,490000,-0.23146871898685178,0.2540664677578478,0.4855351867446996,1,TRUE
Sample2,1,-1,16243,16266,23,190860000,191090000,230000,0.2540664677578478,0.06459656185328533,-0.18946990590456247,1,FALSE
Sample2,1,1,16266,16285,19,191090000,191280000,190000,0.06459656185328533,0.13855321865768838,0.07395665680440305,1,FALSE
Sample2,1,-1,16285,16304,19,191280000,191470000,190000,0.13855321865768838,0.027211180405848644,-0.11134203825183973,1,FALSE
Sample2,1,1,16304,16324,20,191470000,191670000,200000,0.027211180405848644,0.10904606120685165,0.081834880801003,1,FALSE
Sample2,1,-1,16324,16395,71,191670000,192380000,710000,0.10904606120685165,-0.37869499234460485,-0.48774105355145647,1,TRUE
Sample2,1,1,16395,16415,20,192380000,192580000,200000,-0.37869499234460485,-0.16449384849603904,0.2142011438485658,1,FALSE
Sample2,1,-1,16415,16444,29,192580000,192870000,290000,-0.16449384849603904,-0.3682318623456202,-0.20373801384958118,1,FALSE
Sample2,1,1,16444,16489,45,192870000,193320000,450000,-0.3682318623456202,0.43190114571881977,0.80013300806444,1,TRUE
Sample2,1,-1,16489,16500,11,193320000,193430000,110000,0.43190114571881977,0.39671219731563434,-0.03518894840318543,1,FALSE
Sample2,1,1,16500,16516,16,193430000,193590000,160000,0.39671219731563434,0.4241264217592274,0.027414224443593038,1,FALSE
Sample2,1,-1,16516,16567,51,193590000,194100000,510000,0.4241264217592274,0.09759899579177081,-0.32652742596745654,1,FALSE
Sample2,1,1,16567,16587,20,194100000,194300000,200000,0.09759899579177081,0.1739850196858889,0.07638602389411808,1,FALSE
Sample2,1,-1,16587,16624,37,194300000,194670000,370000,0.1739850196858889,-0.05163366205873512,-0.22561868174462402,1,TRUE
Sample2,1,1,16624,16654,30,194670000,194970000,300000,-0.05163366205873512,0.09089055639991996,0.14252421845865507,1,TRUE
Sample2,1,-1,16654,16710,56,194970000,195530000,560000,0.09089055639991996,-0.10035297856112133,-0.1912435349610413,1,TRUE
Sample2,1,1,16710,16748,38,195530000,195910000,380000,-0.10035297856112133,0.09458426172136364,0.19493724028248496,1,TRUE
Sample2,1,-1,16748,16791,43,195910000,196340000,430000,0.09458426172136364,-0.09468356794080335,-0.189267829662167,1,TRUE
Sample2,1,1,16791,16801,10,196340000,196440000,100000,-0.09468356794080335,-0.07565555092079349,0.019028017020009863,1,FALSE
Sample2,1,-1,16801,16854,53,196440000,196970000,530000,-0.07565555092079349,-0.25778961962175534,-0.18213406870096185,1,FALSE
Sample2,1,1,16854,16887,33,196970000,197300000,330000,-0.25778961962175534,0.06332679954500997,0.3211164191667653,1,TRUE
Sample2,1,-1,16887,16929,42,197300000,197720000,420000,0.06332679954500997,-0.29096880713783324,-0.3542956066828432,1,TRUE
Sample2,1,1,16929,16954,25,197720000,197970000,250000,-0.29096880713783324,0.027914900173324,0.3188837073111572,1,TRUE
Sample2,1,-1,16954,16992,38,197970000,198350000,380000,0.027914900173324,-0.2277321010963903,-0.2556470012697143,1,TRUE
Sample2,1,1,16992,17034,42,198350000,198770000,420000,-0.2277321010963903,0.023860623034711884,0.2515927241311022,1,TRUE
Sample2,1,-1,17034,17048,14,198770000,198910000,140000,0.023860623034711884,-0.028718275214245387,-0.05257889824895727,1,TRUE
Sample2,1,1,17048,17080,32,198910000,199230000,320000,-0.028718275214245387,0.08029408138812245,0.10901235660236784,1,TRUE
Sample2,1,-1,17080,17115,35,199230000,199580000,350000,0.08029408138812245,-0.39965376142838543,-0.4799478428165079,1,TRUE
Sample2,1,1,17115,17150,35,199580000,199930000,350000,-0.39965376142838543,-0.048797066593215144,0.3508566948351703,1,FALSE
Sample2,1,-1,17150,17186,36,199930000,200290000,360000,-0.048797066593215144,-0.2796914609464805,-0.23089439435326536,1,FALSE
Sample2,1,1,17186,17241,55,200290000,200840000,550000,-0.2796914609464805,0.21390385759705938,0.4935953185435399,1,TRUE
Sample2,1,-1,17241,17294,53,200840000,201370000,530000,0.21390385759705938,-0.2499958439495913,-0.46389970154665067,1,TRUE
Sample2,1,1,17294,17316,22,201370000,201590000,220000,-0.2499958439495913,0.09713878483467488,0.34713462878426615,1,TRUE
Sample2,1,-1,17316,17337,21,201590000,201800000,210000,0.09713878483467488,-0.15659791209815588,-0.25373669693283074,1,TRUE
Sample2,1,1,17337,17387,50,201800000,202300000,500000,-0.15659791209815588,0.23899092286357992,0.3955888349617358,1,TRUE
Sample2,1,-1,17387,17434,47,202300000,202770000,470000,0.23899092286357992,-0.15814320327012932,-0.39713412613370924,1,TRUE
Sample2,1,1,17434,17461,27,202770000,203040000,270000,-0.15814320327012932,0.2008624942357188,0.3590056975058481,1,TRUE
Sample2,1,-1,17461,17499,38,203040000,203420000,380000,0.2008624942357188,-0.2811296944027685,-0.48199218863848736,1,TRUE
Sample2,1,1,17499,17532,33,203420000,203750000,330000,-0.2811296944027685,0.15501872597715322,0.43614842037992174,1,TRUE
Sample2,1,-1,17532,17553,21,203750000,203960000,210000,0.15501872597715322,0.1042457310517172,-0.05077299492543602,1,FALSE
Sample2,1,1,17553,17568,15,203960000,204110000,150000,0.1042457310517172,0.1379547294600168,0.033708998408299606,1,FALSE
Sample2,1,-1,17568,17595,27,204110000,204380000,270000,0.1379547294600168,-0.16159350343236276,-0.29954823289237953,1,TRUE
Sample2,1,1,17595,17621,26,204380000,204640000,260000,-0.16159350343236276,0.2166777120670595,0.3782712154994222,1,TRUE
Sample2,1,-1,17621,17665,44,204640000,205080000,440000,0.2166777120670595,-0.3425614182429339,-0.5592391303099934,1,TRUE
Sample2,1,1,17665,17694,29,205080000,205370000,290000,-0.3425614182429339,0.19121398080167312,0.533775399044607,1,TRUE
Sample2,1,-1,17694,17719,25,205370000,205620000,250000,0.19121398080167312,-0.033630925356091905,-0.22484490615776503,1,TRUE
Sample2,1,1,17719,17746,27,205620000,205890000,270000,-0.033630925356091905,0.3779141431529422,0.4115450685090341,1,TRUE
Sample2,1,-1,17746,17775,29,205890000,206400000,510000,0.3779141431529422,-0.14694782770916318,-0.5248619708621054,0.5686274509803921,TRUE
Sample2,1,1,17775,17812,37,206400000,206770000,370000,-0.14694782770916318,0.34771425356519453,0.49466208127435773,1,TRUE
Sample2,1,-1,17812,17855,43,206770000,207200000,430000,0.34771425356519453,-0.051065821958068046,-0.39878007552326256,1,TRUE
Sample2,1,1,17855,17876,21,207200000,207410000,210000,-0.051065821958068046,0.09673069588560121,0.14779651784366926,1,TRUE
Sample2,1,-1,17876,17898,22,207410000,207630000,220000,0.09673069588560121,-0.14172411062237966,-0.23845480650798087,1,TRUE
Sample2,1,1,17898,17941,43,207630000,208060000,430000,-0.14172411062237966,0.39436931876512743,0.536093429387507,1,TRUE
Sample2,1,-1,17941,18099,158,208060000,209640000,1580000,0.39436931876512743,-0.4149100344538073,-0.8092793532189347,1,TRUE
Sample2,1,1,18099,18132,33,209640000,209970000,330000,-0.4149100344538073,0.15855717025591345,0.5734672047097208,1,TRUE
Sample2,1,-1,18132,18153,21,209970000,210180000,210000,0.15855717025591345,-0.12311128662873314,-0.2816684568846466,1,TRUE
Sample2,1,1,18153,18181,28,210180000,210460000,280000,-0.12311128662873314,0.42360792648071,0.5467192131094432,1,TRUE
Sample2,1,-1,18181,18241,60,210460000,211060000,600000,0.42360792648071,-0.4847874884841821,-0.9083954149648921,1,TRUE
Sample2,1,1,18241,18278,37,211060000,211430000,370000,-0.4847874884841821,-0.19403773544923858,0.29074975303494355,1,FALSE
Sample2,1,-1,18278,18292,14,211430000,211570000,140000,-0.19403773544923858,-0.2772962242746898,-0.08325848882545123,1,FALSE
Sample2,1,1,18292,18321,29,211570000,211860000,290000,-0.2772962242746898,0.12479066482040153,0.4020868890950913,1,TRUE
Sample2,1,-1,18321,18348,27,211860000,212130000,270000,0.12479066482040153,-0.1880882606864348,-0.3128789255068363,1,TRUE
Sample2,1,1,18348,18408,60,212130000,212730000,600000,-0.1880882606864348,0.14720053313178943,0.33528879381822424,1,TRUE
Sample2,1,-1,18408,18421,13,212730000,212860000,130000,0.14720053313178943,0.11659310076178568,-0.030607432370003754,1,FALSE
Sample2,1,1,18421,18457,36,212860000,213220000,360000,0.11659310076178568,0.3969907132344458,0.2803976124726601,1,FALSE
Sample2,1,-1,18457,18548,91,213220000,214130000,910000,0.3969907132344458,-0.4890035864110884,-0.8859942996455341,1,TRUE
Sample2,1,1,18548,18611,63,214130000,214760000,630000,-0.4890035864110884,0.42607961028447794,0.9150831966955664,1,TRUE
Sample2,1,-1,18611,18682,71,214760000,215470000,710000,0.42607961028447794,-0.006975342958222362,-0.4330549532427003,1,TRUE
Sample2,1,1,18682,18708,26,215470000,215730000,260000,-0.006975342958222362,0.42565404124845224,0.4326293842066746,1,TRUE
Sample2,1,-1,18708,18776,68,215730000,216410000,680000,0.42565404124845224,-0.02448509555932985,-0.4501391368077821,1,TRUE
Sample2,1,1,18776,18793,17,216410000,216580000,170000,-0.02448509555932985,0.0540607407073028,0.07854583626663265,1,TRUE
Sample2,1,-1,18793,18861,68,216580000,217260000,680000,0.0540607407073028,-0.23426024013951205,-0.28832098084681484,1,TRUE
Sample2,1,1,18861,18884,23,217260000,217490000,230000,-0.23426024013951205,-0.13099313157136983,0.10326710856814222,1,FALSE
Sample2,1,-1,18884,18894,10,217490000,217590000,100000,-0.13099313157136983,-0.1571020831996487,-0.026108951628278865,1,FALSE
Sample2,1,1,18894,18905,11,217590000,217700000,110000,-0.1571020831996487,-0.1335579888463446,0.023544094353304096,1,FALSE
Sample2,1,-1,18905,18958,53,217700000,218230000,530000,-0.1335579888463446,-0.4149717095522905,-0.28141372070594595,1,FALSE
Sample2,1,1,18958,18998,40,218230000,218630000,400000,-0.4149717095522905,0.42671984039241023,0.8416915499447007,1,TRUE
Sample2,1,-1,18998,19039,41,218630000,219040000,410000,0.42671984039241023,0.12136245602462045,-0.3053573843677898,1,FALSE
Sample2,1,1,19039,19056,17,219040000,219210000,170000,0.12136245602462045,0.2099032520994927,0.08854079607487225,1,FALSE
Sample2,1,-1,19056,19120,64,219210000,219850000,640000,0.2099032520994927,-0.2879721380605158,-0.4978753901600085,1,TRUE
Sample2,1,1,19120,19174,54,219850000,220390000,540000,-0.2879721380605158,0.28717322747924834,0.5751453655397641,1,TRUE
Sample2,1,-1,19174,19201,27,220390000,220660000,270000,0.28717322747924834,-0.01637618073300872,-0.30354940821225707,1,TRUE
Sample2,1,1,19201,19223,22,220660000,220880000,220000,-0.01637618073300872,0.26305576759959753,0.27943194833260626,1,TRUE
Sample2,1,-1,19223,19267,44,220880000,221320000,440000,0.26305576759959753,-0.36599315347930694,-0.6290489210789045,1,TRUE
Sample2,1,1,19267,19312,45,221320000,221770000,450000,-0.36599315347930694,0.17110521503520285,0.5370983685145098,1,TRUE
Sample2,1,-1,19312,19368,56,221770000,222330000,560000,0.17110521503520285,-0.43586616610246454,-0.6069713811376674,1,TRUE
Sample2,1,1,19368,19414,46,222330000,222790000,460000,-0.43586616610246454,0.29836386747826116,0.7342300335807257,1,TRUE
Sample2,1,-1,19414,19487,73,222790000,223520000,730000,0.29836386747826116,-0.5620019204880079,-0.8603657879662691,1,TRUE
Sample2,1,1,19487,19586,99,223520000,224570000,1050000,-0.5620019204880079,0.34330457868876396,0.9053064991767719,0.9428571428571428,TRUE
Sample2,1,-1,19586,19657,71,224570000,225280000,710000,0.34330457868876396,-0.3935604472017855,-0.7368650258905495,1,TRUE
Sample2,1,1,19657,19680,23,225280000,225510000,230000,-0.3935604472017855,-0.053905433375247114,0.3396550138265384,1,FALSE
Sample2,1,-1,19680,19696,16,225510000,225670000,160000,-0.053905433375247114,-0.1506862984754275,-0.09678086510018039,1,FALSE
Sample2,1,1,19696,19710,14,225670000,225810000,140000,-0.1506862984754275,-0.09452783982153631,0.056158458653891186,1,FALSE
Sample2,1,-1,19710,19725,15,225810000,225960000,150000,-0.09452783982153631,-0.14957693648064588,-0.055049096659109564,1,FALSE
Sample2,1,1,19725,19763,38,225960000,226340000,380000,-0.14957693648064588,0.21713690231722924,0.3667138387978751,1,TRUE
Sample2,1,-1,19763,19797,34,226340000,226680000,340000,0.21713690231722924,-0.27339031849837686,-0.49052722081560607,1,TRUE
Sample2,1,1,19797,19827,30,226680000,226980000,300000,-0.27339031849837686,0.31270030517529784,0.5860906236736747,1,TRUE
Sample2,1,-1,19827,19856,29,226980000,227270000,290000,0.31270030517529784,-0.19251208940323386,-0.5052123945785317,1,TRUE
Sample2,1,1,19856,19879,23,227270000,227500000,230000,-0.19251208940323386,0.10360894220872204,0.2961210316119559,1,TRUE
Sample2,1,-1,19879,19903,24,227500000,227740000,240000,0.10360894220872204,-0.2569231157731154,-0.3605320579818374,1,TRUE
Sample2,1,1,19903,19952,49,227740000,228230000,490000,-0.2569231157731154,0.18400280203195823,0.4409259178050736,1,TRUE
Sample2,1,-1,19952,19972,20,228230000,228430000,200000,0.18400280203195823,-0.022854327159993026,-0.20685712919195126,1,TRUE
Sample2,1,1,19972,20000,28,228430000,228710000,280000,-0.022854327159993026,0.4449057170073223,0.4677600441673153,1,TRUE
Sample2,1,-1,20000,20047,47,228710000,229180000,470000,0.4449057170073223,-0.354781081469965,-0.7996867984772873,1,TRUE
Sample2,1,1,20047,20099,52,229180000,229700000,520000,-0.354781081469965,0.38127355004162855,0.7360546315115936,1,TRUE
Sample2,1,-1,20099,20124,25,229700000,229950000,250000,0.38127355004162855,0.09111486950032135,-0.2901586805413072,1,FALSE
Sample2,1,1,20124,20145,21,229950000,230160000,210000,0.09111486950032135,0.2789623408750695,0.18784747137474814,1,FALSE
Sample2,1,-1,20145,20200,55,230160000,230710000,550000,0.2789623408750695,-0.20024688355629752,-0.47920922443136704,1,TRUE
Sample2,1,1,20200,20223,23,230710000,230940000,230000,-0.20024688355629752,-0.10543287224837197,0.09481401130792555,1,FALSE
Sample2,1,-1,20223,20248,25,230940000,231190000,250000,-0.10543287224837197,-0.3517454525875905,-0.24631258033921852,1,FALSE
Sample2,1,1,20248,20303,55,231190000,231740000,550000,-0.3517454525875905,0.5143977710179821,0.8661432236055726,1,TRUE
Sample2,1,-1,20303,20355,52,231740000,232260000,520000,0.5143977710179821,-0.11486819306171639,-0.6292659640796985,1,TRUE
Sample2,1,1,20355,20369,14,232260000,232400000,140000,-0.11486819306171639,-0.059549640630580866,0.05531855243113552,1,FALSE
Sample2,1,-1,20369,20388,19,232400000,232590000,190000,-0.059549640630580866,-0.2769285196998791,-0.2173788790692982,1,FALSE
Sample2,1,1,20388,20433,45,232590000,233040000,450000,-0.2769285196998791,0.08721968623034215,0.36414820593022124,1,TRUE
Sample2,1,-1,20433,20450,17,233040000,233210000,170000,0.08721968623034215,-0.016424172486910797,-0.10364385871725296,1,TRUE
Sample2,1,1,20450,20476,26,233210000,233470000,260000,-0.016424172486910797,0.37817865596237976,0.39460282844929057,1,TRUE
Sample2,1,-1,20476,20529,53,233470000,234000000,530000,0.37817865596237976,-0.4353074017487983,-0.813486057711178,1,TRUE
Sample2,1,1,20529,20544,15,234000000,234150000,150000,-0.4353074017487983,-0.40094912270266697,0.03435827904613131,1,FALSE
Sample2,1,-1,20544,20559,15,234150000,234300000,150000,-0.40094912270266697,-0.45431497279888067,-0.053365850096213696,1,FALSE
Sample2,1,1,20559,20597,38,234300000,234680000,380000,-0.45431497279888067,0.12914764316729793,0.5834626159661787,1,TRUE
Sample2,1,-1,20597,20626,29,234680000,234970000,290000,0.12914764316729793,-0.08927257322583834,-0.21842021639313627,1,TRUE
Sample2,1,1,20626,20645,19,234970000,235160000,190000,-0.08927257322583834,0.11012148512436755,0.1993940583502059,1,TRUE
Sample2,1,-1,20645,20660,15,235160000,235310000,150000,0.11012148512436755,0.015695069963040133,-0.09442641516132741,1,FALSE
Sample2,1,1,20660,20681,21,235310000,235520000,210000,0.015695069963040133,0.16242720642234837,0.14673213645930824,1,FALSE
Sample2,1,-1,20681,20708,27,235520000,235790000,270000,0.16242720642234837,-0.11384700131472757,-0.27627420773707595,1,TRUE
Sample2,1,1,20708,20740,32,235790000,236110000,320000,-0.11384700131472757,0.3782287304031965,0.49207573171792407,1,TRUE
Sample2,1,-1,20740,20770,30,236110000,236410000,300000,0.3782287304031965,-0.056911789329428454,-0.43514051973262496,1,TRUE
Sample2,1,1,20770,20825,55,236410000,236960000,550000,-0.056911789329428454,0.3533285330915542,0.4102403224209827,1,TRUE
Sample2,1,-1,20825,20964,139,236960000,238350000,1390000,0.3533285330915542,-0.23514227136506716,-0.5884708044566214,1,TRUE
Sample2,1,1,20964,21005,41,238350000,238760000,410000,-0.23514227136506716,0.23073380696732534,0.46587607833239253,1,TRUE
Sample2,1,-1,21005,21058,53,238760000,239290000,530000,0.23073380696732534,-0.14982361161836166,-0.38055741858568704,1,TRUE
Sample2,1,1,21058,21075,17,239290000,239460000,170000,-0.14982361161836166,0.01204083173624341,0.16186444335460506,1,TRUE
Sample2,1,-1,21075,21101,26,239460000,239720000,260000,0.01204083173624341,-0.26218742881995666,-0.2742282605562001,1,TRUE
Sample2,1,1,21101,21147,46,239720000,240180000,460000,-0.26218742881995666,0.05534481372076096,0.3175322425407176,1,TRUE
Sample2,1,-1,21147,21169,22,240180000,240400000,220000,0.05534481372076096,-0.1354928461354847,-0.19083765985624568,1,TRUE
Sample2,1,1,21169,21194,25,240400000,240650000,250000,-0.1354928461354847,0.14071029147234623,0.27620313760783094,1,TRUE
Sample2,1,-1,21194,21265,71,240650000,241360000,710000,0.14071029147234623,-0.4603111682933472,-0.6010214597656934,1,TRUE
Sample2,1,1,21265,21299,34,241360000,241700000,340000,-0.4603111682933472,0.10872960957163576,0.569040777864983,1,TRUE
Sample2,1,-1,21299,21313,14,241700000,241840000,140000,0.10872960957163576,0.039311571018014954,-0.0694180385536208,1,FALSE
Sample2,1,1,21313,21345,32,241840000,242160000,320000,0.039311571018014954,0.44906949840582333,0.40975792738780836,1,FALSE
Sample2,1,-1,21345,21476,131,242160000,243700000,1540000,0.44906949840582333,-0.3851360187604275,-0.8342055171662508,0.8506493506493507,TRUE
Sample2,1,1,21476,21506,30,243700000,244000000,300000,-0.3851360187604275,0.17514020156780102,0.5602762203282285,1,TRUE
Sample2,1,-1,21506,21535,29,244000000,244290000,290000,0.17514020156780102,-0.2505266255666639,-0.4256668271344649,1,TRUE
Sample2,1,1,21535,21548,13,244290000,244420000,130000,-0.2505266255666639,-0.17909353723942653,0.07143308832723735,1,FALSE
Sample2,1,-1,21548,21577,29,244420000,244710000,290000,-0.17909353723942653,-0.29754166452696756,-0.11844812728754103,1,FALSE
Sample2,1,1,21577,21619,42,244710000,245130000,420000,-0.29754166452696756,0.44719313387957504,0.7447347984065427,1,TRUE
Sample2,1,-1,21619,21659,40,245130000,245530000,400000,0.44719313387957504,-0.0012259057458141043,-0.44841903962538915,1,TRUE
Sample2,1,1,21659,21684,25,245530000,245780000,250000,-0.0012259057458141043,0.30293056344488517,0.3041564691906993,1,TRUE
Sample2,1,-1,21684,21738,54,245780000,246320000,540000,0.30293056344488517,-0.5365223767113286,-0.8394529401562139,1,TRUE
Sample2,1,1,21738,21799,61,246320000,246930000,610000,-0.5365223767113286,0.26194552785465974,0.7984679045659884,1,TRUE
Sample2,1,-1,21799,21819,20,246930000,247130000,200000,0.26194552785465974,0.14780621742790762,-0.11413931042675213,1,FALSE
Sample2,1,1,21819,21850,31,247130000,247440000,310000,0.14780621742790762,0.3725502831473552,0.2247440657194476,1,FALSE
Sample2,1,-1,21850,21886,36,247440000,247800000,360000,0.3725502831473552,0.060094967818208986,-0.3124553153291462,1,FALSE
Sample2,1,1,21886,21899,13,247800000,247930000,130000,0.060094967818208986,0.09058136194170223,0.030486394123493243,1,FALSE
Sample2,1,-1,21899,21944,45,247930000,248380000,450000,0.09058136194170223,-0.2939597840904214,-0.38454114603212364,1,TRUE
